Eg trenger en reservasjon 18, med en gruppe på 10 til Sand Lake	V
Minn mej på å levere inn timeplanen min kvar mandag i løpet av slutten av dagen.	V
Skal det regne på søndag.	V
Æ vill bestill en restaurant	T
Ska dt regne på lørdag	T
burde æ ha med et paraply idag?	T
Kor fokti e han i dag?	N
kor varmt ska d vær idag	V
Kan du gi mæ være for hær	T
ka e filmtidan?	T
Legg Ashley McIsaac te min r&b party classics spillelista	T
Finn en restaurant i FM som serverer quiche	V
Finn meg et bord for 8 et sted i Hollenberg om ni uker	B
Æ har løst tel å høre på nokka femtitalls musikk	N
Trenger eg en jakke i dag?	V
Skal det snøve på torsdag.	V
Mirrorshades får tri sterner av meg	V
minn mæ på å levere læringsplanan mine hver mandag på slutten av dagen	T
finn animerte filmar på Caribbean Cinemas	V
minn mæ på å ring mamma idag klokka to	T
Kommer det til å bli sol i dag?	V
Koss komme været te å bli i Meeres-Nationalpark Insel Bastimentos klokkå tolv?	V
minn mæ på om bryllupet	T
Spel ein sang fra åttitalet på Spotify	V
Ska dt regne denne helga?	T
alarm på	T
sett alarm for 6 om morran	T
Book for 3 i U.S. Virgin Islands.	V
Slå av alla alarmer	V
Vis alle alarmer	V
Gi me værmeldinga for dem 3 neste dagan	T
Vis meg påminnelsen min	V
æ vil hør på Music of Ghost in the Shell: Stand Alone Complex	T
vis me påminnnelsen min	T
Er det overskya i dag?	V
Gje 0 av 6 poeng te The Gate of Worlds	V
Legg te Kan Mikami i Pre-Party R&B Jams	V
ka e temperaturen no?	T
vis alle alarma	T
Når går Utamaro and His Five Women på Alamo Drafthouse kino?	B
Legg til Bob Klose i la mejór música para tus fiestas.	V
komme det te å bli snøstorm på min nåværende posisjon	V
Fjern alle påminnelsan mine.	T
Reserver et bord for 10 personer på en restaurant som har internett	B
ranger denne romanen 0 av 6	V
Sett på en alarm for klokka 6 i morgen	B
Æ vil legg te dette albume te funtime .	T
Vis alle alarma.	N
Legg te artisten her te min Jazz spilleliste	T
Slett alle alarma som e satt.	N
slå av alle alarma	T
Spill dei mest populære tjuetalls sangene av Leland Sklar.	V
skru av alarmen	V
vis alle alarma	T
Hvordan er filmoversikten?	B
Book et bord for ti på en resturant med internett.	V
Katti ska han rægne i dag?	N
Kor varmt e det?	V
Finn ett bord for en på et populær churrascaria om tre veke fra no.	V
Hvordan er veret i London?	V
Ka er vermeldingå for de neste tri dagene?	V
Ka e vermeldinga klokka fire over tre i Georgia for overskya forhold i Valley View.	V
Eg vil reservera en restaurant	V
når ska Santikos Theatres vis animerte filma?	T
Kor varmt skal det ver i dag?	V
koss kino e nærmest som vise filma som start om nitten sekund?	T
Skru av alle alarman før i mårra.	N
Kanseller påminnelsen om møtet på hytta.	V
påminn me om å ring mamma i dag klokka 2	T
Lægg tel bright and breezy tel min bright and breezy spællelista.	N
gi tre av seks stjerna t My Sister, My Love	T
Finn animerte filmer på Caribbean Cinemas	V
Spel ein sang av Houston på Spotify	V
spell dem top-tjue sangan av The Kleptones på Spotify	T
Finn timeplanen te Ghost World .	T
Slumra alle alarmene	V
Finn et bord for en på et populært churrascaria i tre uka fra no av	T
e det kaldt ute i dag?	V
Vis mæ alle alarman mine.	N
Sett på en alarm for klokka 07:20 for skoslippet.	B
Vis påminnelsen min	T
ka e PW værmeldningen for stormfullt vær	V
Finn en TV serie som heite Church of the Truly warped.	N
Ska han sny i mårra?	N
legg til cross bones style i Guest List TaKe	V
spill en sang av Juanes på Last fm	T
ka e værmeldingå for 15:04 i Georgia for overskya forhold i Valley View	V
Vis alle alarma.	N
Ska d snø denna ukå?	V
Ka e mine påminnelsa?	T
Gi denna romanen terningkast tre av seks.	V
Sett en alarm for klokkå 17 ikveld	V
denna vinteren vil meredith, betty og erika spisa på en gastropub som e nærme fran sin lokasjon	V
Skru av alle alarmer	V
Ska han sny på torsdag?	N
Book et bord i dag på et steakhouse for 8 som servere sashimi	V
Ka e den nærmeste kinoen som vise en film som starte om nitten sekund?	V
Vis meg tv-serien Limit of Love: Umizaru	V
Vurder The Art of Nijinsky t 5 poeng	V
reserver et bord i Fairview ved siden av området	V
e det minusgrader i dag?	V
Ka e påminnelsan mine?	T
koss e været denna ukå?	V
Ska dt snø denne uka?	T
vurder denne boken tre stjerner	V
Ka e påminnelsene mine?	V
Æ træng en alarm for kl 17 for å minn mæ på å ta medisinen min	T
Trenge eg en jakka idag?	V
Kor kan eg finna The World According to Paris?	V
Bestill bord på en restaurant som serverer agnolotti i Colorado City Idaho.	B
Eg trenger å bli minna på å henta Lisa	V
Sett en alarm klokken 0630 i morgen	V
burde eg ta med ein paraply i dag	V
Spill den beste Charles Neidich-sangen	V
Bestill et bord te ti stykker på ein restaurant som har internett	V
Set en påminnelse om å besøke å mamma næste uka.	V
Avbryt påminnelsene for imårå	V
vis alle alarma	T
Finn en reservasjin førr tre på en topp rangert restaurant	N
Finn visningsprogrammmet te Marcus Corporation	V
Spill den mest populære sangen fra tjuetallet fra Leland Sklar	B
alarm på	T
Gi fem stjerner til denne boka	B
spell av albumet Everybody Happy av Lee Aaron	T
Komme det te å regna denne helgen?	V
Minn meg på å levera timeplanen kver mandag på slutten av dagen	V
Jeg ser etter et sted hvor jeg kan ta med Shawn, Marguerite og Della å spise i nærheten av Rwanda.	B
finn bildet Louder Than Bombs	T
Eg har lyst å finna showet From Where to Eternity.	V
Vis påminnelsen min	T
Finn filmtidene for ArcLight Hollywood.	B
gi det essayet her 2 av 6 stjerna	T
Vis meg alle alarmene mine	V
Ka e temperaturen i London akkurat nu?	N
Æ vil høre albumet Since I Saw You Last.	N
Ska dt regne nær dn nåværende lokasjonen min vd midtnatt ?	T
Gje dennan romanen 0 av 6	N
Sett to alarma for i morga tidlig.	V
Minn meg på å kjøba melk i mårå	V
Kordan skal vere vere i Meeres-National park Insel Bastimentos klokka tolv.	V
Fjern alle satte alarma.	T
kanseller alle alarmer	V
denne vinteren , vil meredith, betty å erika spis på en gastropub som e i samme område som fran befinn sæ	T
finn en reservasjon på en taverna som servere pizza for en gruppe på seks	T
vis alle alarma	T
slå av påminnelsen om møtet på hytta	T
finn filmtidan for ArcLight Hollywood	T
Sett alarm for kl 6 i morra tidli	T
skru av alarm for i morra tidlig	T
Spill musikk på Lastfm	T
Sett alarm for kl. 17 i kveld	T
Sett en alarm kvart tredje minutt.	V
Fortell mæ når det blir varmar i Kina.	N
Sett alarm for kl 6:30 i morra tidli	T
Plis ta på en aen sang i klesvasklistå.	N
Jeg vil bestille bord på en restaurant	B
Ønske å høre albume Since I Saw You Last	T
Gi dn aktuelle romanen en 3 utav 6 vurdering	T
E treng en påminnelse for å hent Lisa	T
Vis min påminnelse	T
Alarm hvert femte minutt i 20 minutt værsåsnill	T
Sett en alarm for klokkå 7 imårå	V
Fortell mej vermeldinga dei neste tre dagene.	V
ska det regn idag?	T
Skru av påminnelser for i morgen	B
e tannlegetimen min i påminnelsan mine?	T
treng æ en jakke idag?	T
Book en reservasjon for en den syttende mars.	V
Lag ein alarm for kvert minutt i elleve minutter	V
Spill nokka David Mallett på last fm	N
Finn film tidan	T
Det aktuelle albumet får 3 av 6 poeng	B
Stopp alarmen for kl 6	V
Avlys min siste påminnelse	B
Slett påminnelsen min for lørdag	T
koss e været denne uka?	T
Vis alle alarmer	V
Fjern alle alarmer som e satt.	V
gi den her essayen tre av seks stjerna	T
Ka e den nærmaste kinoen som vise filmer som starte om nitten sekunder?	V
Finn timeplana for Ghost World	T
Sett en alarm førr klokka tre om morraen på mandag.	N
Spel musikk på Itunes	V
Spill dei beste Charles Neidich sangene te mej.	V
Når skal det regne i dag?	V
E d kaldt i dag?	N
bestill en reservasjon for en den søttende mars	T
Vis alle alarmer	V
ka e værmeldinga for dem kalde temperaturan her om atten minutt?	T
eg trenge ein påminnelse for å henta Lisa	V
Finn bildet Louder Than Bombs	V
Book bord for 10 på en resturang som har internætt.	N
slå av alarmen	T
eg trenge en påminnelse om å henta Lisa	V
Vis alle påminnelsa.	V
Ska det være regn nært der eg e klokken 0.	V
Sett en påminnelse om å ring skolen på mandag kl 4 om morran	T
Spel operamusikk på google music	V
Når skal det regna?	V
reserver en restaurant te klokka seisten i SC	T
Gi me en påminnelse for husstenging klokka 10 i morra.	T
Vis påminnelsen min	T
Æ gjer Hadon of Ancient Opar 2 av 6 poeng.	N
reserver et bord idag på en steakhouse for åtte som servere sashimi	T
Legg t bob klose til la mejor música para tus fiestas	V
Har eg noen påminnelser på?	V
vis alle alarmer	V
Endre i morgens morgenalarm til klokken 6.	V
Ska der ver ein storm i nærheten	V
Ej og Imelda he lyst på en reservasjon i Missouri klokka sju.	V
Book ein Restaurant som servere agnolotti I Colorado City Idaho.	V
Vis alle påminelsa.	V
Fortell me værmeldinga for Guinea-Bissau, vær så snill	T
Slett alle påminnelsa.	N
Skru av alle alarman.	N
Bestill et bord på ein Staekhouse restaurant te åtta stykker som har sashimi	V
Ska han komme me sol i mårra?	N
Finn ut katti Marcus Corporation går på kino.	N
Eg gir Hadon of Ancient Opar to av seks poeng	V
Kordan er været i London?	V
Æ gjer 2 av 6 poeng tel A Tale of Time City.	N
Alarm på	V
Finn et bord t meg for 8 en plass i Hollenberg om ni uker	V
ska det vær varmt i morra?	T
treng e jakke i dag?	T
Finn Vegucated fra klokkå tolv på dagen	V
På den trettende mai 2037 kordan blir det i Wilderville, Montenegro.	V
Sett på to alarmer i morgen tidlig	B
ka ska været vær i Arizona den tredje oktober?	T
Gi meg en lista med filmtider for filmer i området .	V
Ka e luftfuktigheta i dag?	N
Blir det å regne i dag?	N
skru av alarm	V
Slå av alle alarman.	N
Sett en alarm klokka fire om morraen på lørdag.	N
Can du gje meg vermeldingå for her eg e	V
Legge denne låta til i In the arms of a woman-spillelista mi	B
Minn mej på å lage Dan sin lunsj i morga klokka halv åtte.	V
Ka e værmeldingå for neste uke?	V
Finn animerte filma på Caribbean Cinemas.	N
Spill Fereydoun Farrokhzad best track	V
Vis alle påminnelsa satt førr i morra tidlig.	N
Ka e kinoprogrammene	V
vis mæ bildet Rock You Baby	T
vis mæ serien Limit of Love: Umizaru	T
Legg te et album av Joseph Meyer te spelelistå min POP GOES THE 80s takk	V
ska det regn på søndag?	T
Stopp alarmen for klokka 6.	B
Eg trenge en alarm te klokkå 5 for å minna meg på å ta medisinen min.	V
Ska dt bli sol i dag?	T
Bestill bord te lunsj på Boreas te åtta stykk	V
finn en kino med Life and Death	T
Treng æ en jakke i dag?	T
Sett på en alarm for klokka 06:30 i morgen	B
Slætt alle påminnelsan mine.	N
Finn en reservasjon på et taverna som servere pizza førr en gruppa på 6	N
Er tannlegeavtalen min blant påminnelsene mine?	B
Kanseller imorgens påminnelser	V
Vil hørra albumet Since i Saw You Last	V
Bestill bord på en restaurant klokka 16:00 i South-Carolina	B
legg til Ashley McIsaac til r&b party classics spillelisten min	V
Slå av alle mine påminnelsa.	T
spill av Luis Alfonzo Larrain fra 1995	T
Kanseller alarmer	V
Legg morten harket te this is puccini	T
Gi denne stilen 2 utav 6 stjerna	T
Når skal det regne?	V
Vis alle alarmer	V
Vis alle alarna	T
Finn et bilde av Adventure time: The secret nameless Kingdom.	V
Kan du gi mej veret for her.	V
legg te Ashley McIsaac te min r&b festklassikere spilleliste	T
Kan eg få se filmvisningstidene?	V
Sett alarm for kl 7:20 om morran for skoslippe.	T
Slett påminnelsen om å senda melding te Pappa	V
Ej vil høre på nokke femtitalls musikk.	V
Slett alle alarma.	N
Spill albumet Vibrations av Marion Elise Raven	V
Minn mæ på at æ skal dra på butikken seinere.	N
Slå av alle alarma på lørdag	T
Skru av alle alarmer	V
Kommer det til å snø i morgen?	B
Finn animerte filma på Caribbean Cinemas.	N
Kor mange millimeter med regn skal oss få i morga.	V
putt detta albumet på min dubstep dangles dirty spillelista	V
Kor varmt e det?	V
trenger eg en paraply i morgen	V
Ka vær advarsla har æ?	T
Spill de mest populære albumene fra tjuetallet fra Leland Sklar	B
sett dt hær albume på dubstep dangles dirty spillelista mi	T
Slett påminnelsen min for å henta Patrick på skolen i mårå.	V
Kor varmt e d?	V
kor varmt ska det bli i dag	V
Vis mæ serien Limit of Love: Umizaru.	N
Kommer det til å snø i dag?	B
Finn et bord for en populær churrascaria om 3 uke.	V
Blir det sol i dag?	V
Komme d t å vær snø på denna posisjonen innen 3 mars ?	V
Vis mej påminnelsen min.	V
ka e PW meldinga for stormvær?	T
Kommer det til å regne i dag?	B
Når skal det slutte å regne?	B
Vis alle alarmer	V
Gje mæ en påminnelse i morra klokka 10 om at æ skal selge et hus.	N
Ka er påminnelsene mine?	V
finn The Ultimate Gift, en tv-serie	T
for Mirrorshades gir æ det tre stjerna	T
Kanseller morgendagens påminnelser	V
Er tannlegetimen min i påminnelsene mine?	B
Ka e filmtidene på Caribbean Cinemas ?	V
Æ vil høre albumet Since I Saw You Last.	N
Kommer det til å regne neste uke	B
E tannlegetimen min i påminnelsan mine ?	N
Vis boknavnet Straight No Chase	B
Legg te bright and breezy i This is Gucci Mane spillelistå mi	V
Reserver for 7 personer på The French Laundry 8ende juni, 2029	V
Bestill på The Halal guys syttene oktober	B
Vis meg alarmene mine	V
Vis alle alarma.	N
Ranger dinna romanen null av seks.	V
vis alle alarmer	V
Finn en reservasjon i en taverna som servere pizza t en gruppe på 6	T
Koss e været nærme Triumph	V
i vinter vil meredith, betty og erika spis på en gastropub som e i samme område som fran sin plassering	V
fortell mæ værmeldinga for 3 daga	T
Spill Shadowplay av Dana på DeezerDeezer er en musikkapp	B
Spill albumet Vibrations av Marion Elise Raven.	V
reserver en restaurant som servere agnolotti i Colorado City Idaho	T
Kor kan eg finne The World According to Paris?	V
Bli dt sol i dag?	T
