Sett en alarm førr klokka fem om morraen.	N
Ka e film tidspunktan for Caribbean Cinemas ?	T
Sett en alarm til mandag klokka 3.	V
Skal det bli storm i nærheten.	V
Book en restaurant kl 16 i SC	V
Kan eg se kinoprogrammet?	V
Spel ein sang av Juanes på Last Fm	V
Reserver bord på et top-rangert osteria	V
minn meg på å lage lunsjen te Dan kl 7:30 i mårå.	V
Finn en trailer kallt Storm Center .	T
finn bildet Louder Than Bombs	T
slå av alle alarma	T
sett alarm til klokka 6	T
Finn en kino nærmest som viser Operation: Kingdom	V
Book en restaurant for me klokka ni i Statham	T
spell musikk på Lastfm	T
Vis alle påminnelser.	B
Bruk Groove Shark for å spilla musikk fra åttitallet	V
Eg trenge et bord t 4 på en restaurant rundt kl 00 .	V
legg te sangen her te min perfekt italiensk middag spilleliste	T
Book en reservasjon for 1 den 17. mars	T
sett en alarm for mandag klokka tre på morran	T
kanseller alle påminnelser	V
Vis alle alarma	T
Kor kaldt ska dt bli i dag?	T
Avbryt påminnelsen min om å send melding t pappa	T
sett alarm for kl. 6	V
vær i Tioga Colorado	T
Vis påminnelsen min.	N
Vis påminnelsen min	T
Sett på to alarmer for imårå tidlig	V
koss kino vise Flower and Snake klokka 08:56:29?	T
minn me på å dra t tannlegen enste mandag	T
Kor kaldt vil d bli i dag?	N
Koss e været nærme Triumph	V
Bestill bord på en høyt vurdert osteria om syv uker fra nå	B
Ka e påminnelsene mine?	V
Kordan filma er det som går i nærheita av mæ?	N
Ska det ver overskya i Georgia 15:04 i Valley View i følge vermeldingå?	V
vennligst fortell mæ værmeldinga for Guinea-Bissau	T
Vis meg alle alarmene	V
Vil det være snø på den nåværende posisjonen 3. Mars	V
slå av alarmen	T
Skru av alarm.	B
Kanseller alle alarma.	V
Sett en alarm for klokka 5.	V
Alarm hvert femte minutt for 10 minutta vær så snill	T
Spæll den bæste Charles Neidich sangen.	N
Skru av alarm	B
Gi tri stjerner /6 te My Sister, My Love	V
Når kommer Utamaro and His Five Women hos Alamo Drafthouse Cinema	B
slett påminnelsen min for å hent Patrick på skolen i morra	T
Kanseller alle påminnelsene mine.	V
Kjæm dt te å snø i morra?	T
Sett ein alarm te kl. 7:20 for sko utgivelsen.	V
Finn bilde som heite Between the Days.	N
Spill musikk fra spillelisten Kom i riktig humør	B
Vis mæ bilde av Rock You Baby.	N
Ka e nest ukes værmelding?	T
Sett på to vekkerklokker for i morgen tidlig	B
Skru av påminnelsen min om å ringe pappa.	B
Sett på en alarm for klokka 6.	B
Vis From South Africa to South Carolina	T
æ treng en påminnelse te å plukk opp Lisa	T
Blir det å regne på lørdag?	N
Skru av alle alarma.	V
Fjern alle påminnelsa.	N
vis alle alarmer	V
Kati blir det å regne?	N
Spæll albumet Vibrations av Marion Elise Raven.	N
Koss vil være vær i Meeres-Nationalpark Insel Bastimentos kl tolv på dagen ?	T
slå av alarmen min for i morra tidli	T
Slumre alarmen.	N
Skru av alarm.	N
Kommer det til å blåse i dag?	V
Skal det regne i morga?	V
Kor varmt e det?	V
E tannlegetimen min i påminnelsan mine ?	N
koss e været den uka her?	T
fjern alle påminnelsa	T
Ka tid vises Utamaro and His Five Woman på Alamo Drafthouse Cinema	V
Legg te denne artisten te jazz spelelistå mi	V
Gje mæ en oversikt over filma som får i nærheita av mæ.	N
e dt kaldt ute i dag?	T
Book mej en resturant til ni stykke i Statham.	V
Finn en kino med Life and Death	T
Ska det regn neste uke?	T
Vis alle alarma.	N
legg te cross bones style te gjesteliste TaKe	T
Kordan e været i nærheta av Triumph	N
Finn filmtidan t me	T
Vurder dette essayet te tri av seks stjerner	V
lag en ny alarm for torsdag klokka ett på dagen	T
Slå av alle alarma	T
Legg til sangen Nastya Kamenskih i spillelista mi The Martin Garrix Show.	N
Æ gir Hadon of Ancient Opar to utav 5 poeng	T
Vurder dette essayet til tre av 6 stjerner	V
Finn visninger av Vegucated som begynner klokka 12:00	B
Eg gir seks poeng te Hadon of Ancient Opar	V
Sett på en vekkerklokke for klokka 6	B
Finn en plan før Ghost World.	N
Hvilke påminnelser har eg?	V
Når ska d regna?	V
spell den mest kjente sangen av Leland Sklar fra tjue-tallet	T
Minn mæ på å kjøpe melk i kveld.	N
Slett påminnelsen min om å henta Patrick på skolen imårå.	V
skru av alarm	V
Legg til denne sangen til den perfekte italianske middags spillelisten min	V
Blir det å være vind i NY klokka 16?	N
finn et fotografi kalt Betwee the Days	B
når ska det slutt å regn?	T
Gje mæ en påminnelse om å ringe mammma i dag kl 2.	N
Finn en trailer som heter Storm Center	B
Bruk Groove Sharks til å spille musikk fra åttitallet	N
vis alle påminnelsa	T
ska det regne i dag	V
sett på en alarm hvert tredje minutt	T
Gjer The Art of Nijinsky 5 poeng.	N
kanseller alarmen min for i mårå tidlig	V
Ska det snø i dag	T
Blir det å regne i helga?	N
E det overskya idag?	T
Skal det bli kaldere i La Mesa.	V
Vis mæ mine alarma	T
Gi kunsten t Nijinsky 5 poeng	T
Book på Halal Guys den 17. oktober	T
Vis boka kalt Straigh No Chase	B
stacy watson og adriana vil gå på den beste osteriaen i HalloWell Minnesota i ettermiddag	V
Skal det regne i dag?	V
Spill den mest populære 20-tallssangen fra Leland Sklar	T
Spill shadowplay av Dana on Deezer .	V
Ka kino viser Flower and Snake klokken 08:56:29?	V
Gi den boka her fem stjerna	T
E det fuktig i dag?	V
Vis meg bildet Rock You Baby	V
Kan du sette på en alarm for klokka 4 på søndag?	B
spell operamusikk på google music	T
Slett alarmen for i mårå tidligt	V
Søk etter TV-serien Chasing Fortune.	N
Sett på Kan Mikami på Pre-Party R&B Jams.	N
Hvor kaldt kommer det til å være om morgenen i morgen?	B
været i Tioga Colorado	V
ska det regn den helga her?	T
eg trenger en påminnelse for å hente Lisa	V
Spel någe David Mallett på last fm	V
Les opp påminnelsan mine førr mæ.	N
Skru av alle alarma	T
Kor mange alarmer har eg på t søndag?	V
spill toppsanger av Joseph Utsler	V
Kommer det til å være snøstorm der jeg er nå?	B
Gi tre stjerna / 6 te My Sister, My Love	T
sett ein alarm for kl. 6.15	V
Book en restaurant i Colorado City Idaho som servere agnolotti .	V
finn et videospill som heter IBM Program temporary fix	V
I villa likt å se sagaen 12 Soulful Nights of Christmas	T
Finn en reseversjon for en pub som servere pizza før 6 persona.	N
legg det albumet her på dubstep dangled dirty-spillelista mi	T
Speles Tarzan of the Apes på Cobb Theatres?	V
legg til Armen Movsessian i this is skepta spillelista	N
Sett på en alarm hvert tiende minutt, fra 17:30 til 18:00	B
ska det bli sol i morra?	T
slå av alle påminnelsa	T
Legg til morten harket i this is puccino	N
Kan jeg få filmoversikten?	B
Skru av alarmen min for lørdag	T
Legg Cross bones style til i Guest List TaKe	B
Finn ein reservasjon for ein taverna som servere pizza for 6 stykk	V
Ka e værmeldinga før dæm næste 5 dagan.	N
Koss komme været te å bli i Arizona den tredje oktober	V
Ej trenge en reservasjon til klokka 6 for 10 stykke i Sand Lake.	V
skru av alarm	V
Reserver et bord for 6 personer på en taverna som selger pizza	B
Æ gjer den her novella 0 av 6.	N
Sett på en påminnelse om å gå i butikken etterpå	B
Stacy Watson og Adriana har lyst til å dra på den beste osterian i Hallowell Minnesota i ettermiddag	B
Kor mange alarma har æ satt på tel søndag.	N
Når komme d t å regna idag?	V
e villa gitt Half a life 3 av 6	T
ka e temperaturen nå?	V
Vår så snill å legg et ablum av Joseph Meyer på POP GOES THE 80s spillelista mi	T
skru av alarmen	T
Vis meg alarmene mine	V
Finn et spill som heite IMB Program temporary fix.	V
Bestill et bord i dag for åtte personer hos en biffrestaurant som selger sashimi	B
Alarm på	V
Hvilke væradvarsler har jeg?	B
Legg te Nastya Kamenskih sangen te spelelistå The Martin Garrix Show	V
skru av alarm	V
minn meg på å ringe mamma i dag kl. 14	V
Burde ej ha på mej ei jakke i dag?	V
stacy watson å adriana vil dra på dn beste osterian i Hallowell Minnesota denne ettermiddagen	T
korr kaldt ska det bli om morran?	T
ska det snø på torsdag	V
Kommer det til å regne i helga?	B
Spill albume Vibrations av Marion Elise Raven	T
Lægg tel Jacob Hoggard tel min get going spællelista.	N
Kordan e verest nær Triumph.	V
Være i Tioga Colorado.	N
vis alle alarmer	V
Gje tri poeng te bogå	V
kanseller alle påminnelsene mine	V
Fjern påminnelsan for i morra	T
Vis mæ værmeldinga for Wisconsin	T
Ska dt bli my vind i dag?	T
Finn en TV serie kalt hurch of the Truly Warped .	N
Legg til ein påminnelse	V
alarm på	V
burda e ha på jakke i dag?	T
Spill av topp 20 sangene av The Kleptones på Spotify	V
Æ har løst å høre på 50-tallsmusikk.	N
spill sanger fra førtitallet	V
Sett alarm for kl 7 i morra tidli	T
Skru av alarmen.	N
Ka e fuktighetsnivået i dag?	T
Ka blir været å være i Arizona tredje oktober?	N
Alarm for kvert femte minutt i tjue minutter takk	V
spill førtitalls låta	T
Skru av alle alarma	T
Blir det å snø på torsdag?	N
Æ har løst tel å ta med shawn, marguerite og della til et sted å spise i nærheta av Rwanda.	N
spell låta fra førti-tallet	T
herre albumet får tre av seks poeng	T
ska det bli varmt i mårå	V
ka e været meldt i Meeres-Nationalpark Insel Bestimentos klokka tolv på dagen?	T
e det under frysepunktet i dag?	V
sett en alarm for klokkå 6	V
minn meg på om bryllupet	V
kjem vinden te å ro sæ ned på min nåværende plassering te kveldsmat?	T
Ej vil finne showet From Where to Eternity.	V
Finn ein TV serie som hette Church of the Truly Warped	V
Kor varmt e dt?	T
legg t Do You Love Me på den akustiske soul-spillelista mi	T
Bestill et bord for tre på en høyt vurdert restaurant	B
Spel litt Mf Doom fra sekstitallet på pandora.	V
skru av alarmen	V
finn den nærmaste kinoen som vise Operation: Kingdom	V
legg Do You Love Me på min akustisk soul spillelista	V
legg til låt 70s smash hits til min	V
Spill en melodi fra åttitalle på Spotify	T
slå av alarmen min for i morra tidlig	T
Kati blir the Santinos Theatres å vise animerte filma	N
Vis mej påminnelsene min.	V
He ej nokken påminnelsa satt?	V
Slett påminnelsen om møtet på losjen	V
Ka e luftfuktigheten idag?	V
Ka e temperaturen akkurat nu?	N
Finn et bilde av Adventure Time: The Secret pf the Nameless Kingdom	N
Spill førtitalssanga.	V
legg Jacob Hoggard t min get going spillelista	V
Vis mæ bildet Rock You Baby.	N
Eg vil legga t detta albumet t funtime .	V
Æ vil reserver en restaurant	T
Legg til bright and breezy til This is Gucci Mane spillelista mi.	V
Sett ein påminnelse for å dra te matbutikken seinåre	V
Slå av alarmen for i ettermiddag.	T
Vil d bli sol i dag?	N
Gi denne romanen en bedømmelse på 3 av 6	B
Stopp alarmen for klokka seks	T
Æ træng et bord for 4 på en restaurant rundt midnatt .	T
Kass værvarsler har eg?	V
koss kjem været te å vær om seks minutt i nærheten av Moosic	T
Ej vil gjerne sjå spilletidene til Sully Movie 2.0 på kino.	V
Alarm på	B
Eg trenge ein alarm for kl. 17 for å minne meg på å ta medisinene mine	V
e det kaldt i dag?	T
Komme det te å bli kjøligere i La Mesa?	V
Sett alarm førr klokka seks om morraen.	N
slå av alarmen	T
reserver nær Montana restaurant som servere mat fra sri lanka for 6 som e høyt rangert på tirsdag.	T
Reserver ein restaurant som servere agnolotti i Colorado City Idaho.	V
Vill vinden roe sæ ned hær?	N
Ska d regna nærme min nåværandes posisjon kl 00 ?	V
Sett på en påminnelse for å gå på butikken senere.	V
Legg t cross bones style i Guest List taKe	T
Sett en alarmen før kl 6.	N
vis alle påminnelsa for i morra tidlig	T
sett ein alarm for mandag kl. 3	V
Sett en alarm førr klokka 5 om morraen.	N
Finn Vegucated som starte 12	T
Spill shadowplay av Dana på Deezer.	N
show av From South Africa to South Carolina	V
Fortell mæ kordan sanga som spælle på AMC kino.	N
Æ træng en reservasjon for kl 18 m et selskap på 10 vd Sand Lake	T
Ka e filmvisningstidene	V
Minn meg på å dra te tannlegen neste mandag	V
Slå av alle alarman	T
Legg til Do You Love Me i acoustic soul-spillelista mi	B
Ka komme varmeindeksen te å vær på i dag?	V
Ka e værmeldingå for de neste 5 dagene?	V
Spill et spor fra 2004	B
Slett påminnelsen om å plukke opp Patrick fra skulen i morga.	V
Ej trenge ett bord for fire på resturanten rundt tolv.	V
Stopp alarm for kl 6 om morran	T
Bestill et bord på en restaurant for meg klokka 21:00 i Statham	B
Book en reservasjon for 7 på The French Laundry den 8. juni, 2029	T
sett på en alarm klokken 0600	V
Kanseller alle alarmene for i morga?	V
Sett på ein alarm for kvert tiende minutt som ska starta halv seks og slutta seks om morningen	V
Vis alle alarmer	V
Vis alle alarma	T
Skru av alarmen min for i morgen tidlig	B
Ka e luftfuktigheten idag?	T
Når skal Santikos Theatres vise animerte filma.	V
Lag ein reservasjon te éin syvende mars	V
Skru av alle påminnelser	B
E d overskya idag?	V
Slett alle påminnelser	V
Lægg til den her artisten til min Jazz lista.	N
Sett på en alarm for klokka 6	B
spill topp sanga av Joseph Utsler	T
spill Luis Alfonzo Larrain fra 1995	V
Legg Nastya Kamenskih sang te The Martin Garrix Show spillelista mi.	T
Kan æ se film timeplanan ?	T
treng e paraply i morra?	T
Søk på Chasing Fortune a TV series.	V
Spill en sang av Juanes på Last Fm	B
Finn ein restaurant i FM som serverer quiche	V
Finn mæ The Twinkler som spille på National Amusements om 2 minutt.	N
Skru av alle alarmene	V
Kommer det til å være storm i Bordentown i dag?	B
Vis meg Happiness Was Free	V
Skal det snøve dinna veka?	V
Bestill ein reservasjon for 1 den 17 mars	V
Ska det regna på søndag?	V
Sett en alarm kvart minutt i elleve minutta.	V
Ska det være kaldt i Vest Sahara om 13 timer	V
Sett alarm til klokka 5	T
Gi tre stjerner / 6 t My Sister, My Love	V
avbryt alarmen min for imårå tidlig	V
Legg til bob klose i la mejor música para tus fiestas.	N
Skru av alle alarmer	V
Skru av alarmen.	N
Skru av alarman.	N
Sett på ein alarm for klokkå seks	V
Åpne Spotify og spæll en sang fra 20-tallet av Richard Harvey.	N
legg te bright and breezy te min This Is Gucci Mane spilleliste	T
Ka e værmeldinga klokka 15:04 i Georgia førr overskya vær i Valley View	N
Spill en sang fra 2004	V
Legg til påminnelse om å svøm klokka elleve i morra	T
Koss vil være vær i Bahamas elleve år å et halvt fra no	T
Sett ein påminnelse for besøket te mamma neste uke	V
Ska han rænge på lørdag?	N
finn et bord for en på en populær churrascaria for tre uka fra no	T
Skru av alle alarma	T
Sett en alarm til klokka 6 på onsdag	T
Finn filmtiden førr Marcus Corporation .	N
Kan du finna et bord te åtta stykk i Hollenberg om ni ugår?	V
Vis meg alle påminnelsene for i mårå	V
Book en lunsj førr åtte persona på Boreas.	N
Den her vintern vil meredith, betty og erika ha mat ei kro som e i samme område som Fran.	N
Legg t en påminnelse om å svømma kl 11 imårå	V
Trettende mai, 2037 koss vil det bli i Wilderville, Montenegro	V
reserver et bord for meg og steonkelen min i Malta på ein kafeteria	V
Slumre alle alarmer	V
Æ vil finne showet From Where to Eternity .	N
Legg til dette albumet på min dubstep dangles dirty spilleliste	V
Alarm på.	N
Gi tre stjerner av seks til My Sister, My Love	B
Skift alarmen imårå tidlig t klokkå 6.	V
ska det vær vind i NY klokka fire på ettermiddagen?	T
Sett en alarm klokka ti på halv åtte førr skolanseringa.	N
Spæll opera musikk på google music.	N
reserver hos The Halal Guys den 17. oktober	V
finn The Ultimate Gift, et TV program	V
Denne vinteren vil meredith, betty og erika spise på en gastropub som e i samme område som fran	V
Avlys mine påminnelsa og send melding tel han pappa.	N
usikker	B
ka e PW værvarselet for stormfullt vær	V
Stopp alarm for kl. 6	V
Jeg vil gjerne se visningstidene til Silly Movie 2.0 på kinoen	B
Vis alle alarman mine	T
komme det te å vær kjølig i Western Sahara om 13 timer	V
Komme det te å vær stormer i Bordentown i dag	V
Slett alle alarmene.	V
Sett en påminnelse for å gå t butikken seinar	T
Finn ein visning av The Twinkler på National Amusement om 2 minutter	V
minn me på å lag Dans lunsj klokka 7:30 i morra	T
Er det kaldt ute?	B
legg Armen Movsessian t i this is skepta spillelistå	V
E d skya i dag?	N
æ og imelda vil ha en reservasjon i Missouri klokka sju	T
ska det snø te uka?	T
Slett alle alarmer	V
finn bildet Louder Than Bombs	T
Ka e film tidsplanan	T
Book et bord for 10 persona på en restaurant med internett	T
korr kan æ finn The World According to Paris?	T
Spill opera musikk på google music.	V
reserver en restaurant i nærheten av Montana som servere srilankansk mat for seks som har en høy vurdering på tirsdag	T
sett ein alarm for kl. 6	V
finn Vegucated som starte klokkå tolv	V
E og Imelda vil ha en reservasjon i Missouri klokka 7	T
Legg bright and breezy til i spillelista mi This is Gucci Mane	B
Burde æ ha på en jakke i dag	T
finn animerte filmer på Karibiske Kinoer.	V
Eg ønske å hørra på någe femtitallsmusikk.	V
koss bli været i Arizona 3. oktober?	T
Kanseller den siste påminnelsen min	V
Stopp alarmen førr klokka seks.	N
legg til sang i my Para comer	N
Skal det regne på søndag?	V
Ska det regne i dag?	V
Kor kan eg finna The World According to Paris	V
Gi ti poeng til The Tenor Wore Tapshoes	N
Sett enn påminnelse om å fære tel butikken seinar.	N
Koss e temperaturen i London akkurat nå?	V
Spill musikk på Itunes	T
Når ska det regn i dag?	T
Kor kaldt kommer det til å være på morgenen?	V
Legg te bob klose te la mejor música para tus fiestas	V
Finn ein reservasjon for tri på ein topp rangert restaurant	V
Avlys alle mine påminnelsa	N
Treng å paraply i morra?	N
Vis me alle påminnelsan for i morra	T
Fjern alle satte alarma	T
Veret i Tioga Colorado.	V
Gi 2 av 6 poeng t A Tale of time City	V
Ska det bli sol i dag?	T
Ska d rængne på søndag?	N
Minn meg på å kjøba kaffi på Starbucks i ittemiddag	V
Vis mæ påminnelsan mine.	N
Reserver meg ein lunsj hos Boreas for ein gruppe på 8	V
spell musikk på Itunes	T
Spel ein sang fra to tusen og fira	V
sett en påminnelse om mammas besøk neste uke	T
Spill de beste sangan av Fereydoun Farrokhzad	N
bestill et bord i Fairview atme området	T
Eg vil se visningstidene til Silly Movie 2.0 på filmhuset	V
legg te spor 70s smash hits te min	V
Spill dn beste Charles Neidich sangen	T
Ska det bli sol i dag?	V
Spæll albumet Everybody Happy av Lee Aaron.	N
Kommer det til å snø i morgen?	B
Ej rangera Mirrorshades tre stjerne.	V
Blir det å regne i helga?	N
Ka tid ska Utamaro and His Five Women spelast på Alamo Drafthouse Cinema	V
Ska det ver varmt i mårå?	V
Ka for någen påminnelser har eg?	V
legg Armen Movsesssian te dette e skepta spillelista	T
Finn film tidene til mej.	V
Vil det være vinn kl 4 i NY?	N
Ej trenge en påminnelse om å plukke opp Lisa.	V
Kordan er være den her uka?	N
Kanseller påminnelsene for i morga.	V
Kommer det til å regne på lørdag?	B
Sett en alarm kvart minutt i 11 minutt	V
Komme det te å bli sol i mårå?	V
Kordan alarma har æ på?	N
Kanseller påminnelsen min om å sende melding te pappa	V
Finn et fotografi av Adventure Time: The Secret of the Nameless Kingdom	V
Fortell mej ka filma som spilles no på AMC Theaters.	V
Finn et fotografi fra Adventure Time: The Secret of the Nameless Kingdom	V
Vis alle alarma.	N
Finn en TV-serie som heter Church of the Truly Warped.	V
Kommer det til å bli kaldere i La Mesa	V
Ka e luftfuktigheten i dag?	V
Kommer jeg til å trenge jakka mi i dag?	B
vis alle påminnelsa	T
Legg t Morten Harket til this is puccini	T
Endre alarmen for i morra tidlig til klokka 6	T
Spill av den beste Charles Neidich-sangen	T
Ka e luftfoktigheita i dag?	N
Legg te morten harket te this is puccini	V
Koss filma ska gå i nabolaget?	T
finn filmmusikk som har tittelen The House of The Yellow Carpet	V
Abryt alarmen for denna ettermiddagen.	V
Legg sangen te Para Comer	V
legg te låt 70s smash hots te min	T
Vurder den aktuelle romanen 0 av 6	V
slå av alarm	T
Har æ satt på non påminnelsa?	T
æ vil legg te herre albumet te funtime	T
Kor varmt e det?	V
Les påminnelsene mine.	V
legg te cross bones style te Guest List TaKe	V
vis alle alarmer	V
Gi to av seks poeng til A Tale of Time City	B
Kor kaldt skal det ver om morningen?	V
eg og imelda vil ha ein reservasjon i Missouri kl. 7	V
Ka e temperaturen i London akkurat no?	T
ska dt vær en snøstorm på min nåværende posisjon	T
Kass e den nærmaste kinoen som vise filmar som starte om nitten sekund ?	V
Finn spilletidene for ArcLight Hollywood.	V
Ska det regna nærme min nåværende posisjon kl. 12?	V
finn det nærmeste filmhuset som vise Operation: Kingdom	T
Bestill en reservasjon for 1 17. mars	V
koss ska det vær i Wilderville, Montenegro den trettende mai i 2037?	T
Reserver bord på ein Restaurant klokkå seisten i SC	V
Book et bord for 7 person på The French Laundry 8.june, 2029.	N
Spill den mest populære tjueårslåten fra Leland Sklar	V
Spill albumet Vibrations av Marion Elise Raven	N
Vis alle alarmer	V
Fjern alarmen som e satt førr i ettermiddag.	N
koss filmhus vise Flower and Snake klokka 08:56:29?	T
Slå på alarm til klokka 6 i morra	T
sei meg værmeldingen for de 3 neste dagene	V
Finn Vegacuted som starter klokka tolv.	V
Skal det regne i dag?	V
Finn The Twinkler som spelles på National Amusements om to minutt	T
Skal det snøve i dag?	V
ska det snø den uka her?	T
Vis mæ Happiness Was Free .	N
Ska dt storme i dag?	T
Vis påminnelsen min	T
Eg trenger et bord til 4 på en restaurant klokken 0.	V
Kor varmt skal det vere i dag?	V
avbryt alarmen	T
Sett en alarm for kvart tiende minutt, fra klokkå 05:30 t 06.	V
Gje dettan essayet tre av 6 stjerne	N
finn filmtidan for Marcus Corporation	T
Spill av Shadowplay av Dana på Deezer	T
Legg til dennan artisten i Jazz spillelista mi	N
Bruk Groove Shark til å spille musikk fra åttitallet	V
Ka e være i nærheita av Triumph ?	N
vurder den nåværandes novellå 0 av 6	V
Stopp vekkerklokka for klokka 6	B
Gje fem stjerner te bogå	V
Spill albumet Everybody Happy av Lee Aaron	N
Vis alle påminnelsene for i morgen tidlig	V
E vil hør på Music of Ghost in the Shell: Stand Alone Complex	T
Kor varmt blir det i dag?	N
legg den her te min dubstep dangles dirty spilleliste	T
Lag en ny alarm for torsdag klokken 13.	V
E det kaldt i dag?	V
Kordan e værmeldingen om atten minutter her med tanke på kaldere temperaturer	V
Ka filmer vises i nabolaget?	V
Eg vil finna showet From Where to Eternity .	V
finn en reservasjon for tre på en topp-scora restaurant	T
Kan du fortelle mej vermeldinga for Guinea-Bissau.	V
Skru av alle alarma	T
skru av alarm	V
Vis alle alarma	T
Alarm kvert 5 minutt i 20 minutter vær så snill	V
Æ treng en alarm klokka 5 førr å minne mæ på å ta medisinen min.	N
gi tre stjerna / seks te Min Søster, Min Kjærlighet	T
Når ska Santikos Theatres visa animerte filmer?	V
legg te Morten Harket te this is puccini	T
kanseller alle påminellser	V
Finn et foto av Adventure Time: The Secret of the Nameless Kingdom	T
Legg te cross bones style te Guest List TaKe	V
Kanseller påminnelsan æ har satt førr i morra.	N
sett en alarm klokka sju tyve for skoutgivelsen	T
Kordan vil veret ver i Bahamas om elleve år fra nå?	V
Spæll musikk på Lastfm.	N
Eg ønske å ta med shawn, marguerite and delia te et sted å spisa i nærheten av Rwanda.	V
Åpne Spotify og spill en sang fra tjuetallet av Richard Harvey	V
korr varmt ska det bli i dag	T
reserver for tre i U.S. Virgin Islands	T
Gi tre stjerner / 6 til My Sister, My Love	V
book på The Halal Guys den 17. oktober	V
Finn bildet Louder than Bombs	B
skru av alle alarma	T
gi med en oversikt over filmtidan for filma i området	T
legg te Kan Mikami i Pre-Party R&B Jams	T
Spel musikk på LastFM	V
Kjem det til å snøve i morga?	V
Legg denne sangen til i spillelista mi den perfekte italienske middag	B
Vis mæ påminnelsan mine.	N
Ka e den nærmeste kinoen som viser filmer som starter etter nitten sekunder?	V
Sett en femten-minutters alarm.	N
reserver et bord i dag på et steakhouse for åtte som servere sashimi	T
Skru av alle påsatte alarmer	B
vis påminnelsan mine	T
Slumre alarm	V
Komme det te å snø i mårå?	V
Ka e fuktighetsnivået i dag?	T
Book bord på The Halal Guys 17 oktober.	N
Gi denna boka tre sjerne.	N
Ska det snø på lørdag?	V
Kommer eg til å trenge en jakke i dag?	V
Koss bli været om seks minutt nærme Moosic?	T
sett en alarm for klokkå 6	V
Vis alle alarma	T
Skru av alramen.	N
Sett alarmen til klokka 4 den her lørdagen, vær så snill	T
e dt under frysepunkte i dag?	T
Gje mæ en påminnelse om bryllupet.	N
Finn en restaurant i FM som serverer kish	B
Minn meg på å kjøpa kaffi på Starbucks i ettermiddag	V
Spill Luis Alfonzo Larrain fra 1995.	V
skru av alarm	V
æ har lyst te å sjå sagan 12 Soulful Nights of Christmas	T
Legg te dette albumet i spelelistå dubstep dangles dirty	V
Vis alle alarma	T
Sett på en alarm for mandag klokka 15	B
legg te Jacob Hoggard te min get going spilleliste	V
Vis påminnelsen min	V
Koss kino e nærmest som vise filma som starte om 19 sekund?	T
Legg detta albumet til i dubstep dangles dirty spillelista mi	N
spell den beste sangen av Fereydoun Farrokhzad	T
Finn bildet Louder Than Bombs.	N
Skru av alle alarman før i mårra.	N
Ska det regn idag?	T
Blir det å være sol i dag?	N
Kommer det til å bli fint vær i dag?	B
Veret i Tioga Colorado	V
Skal det vere en snøvstorm der ej e no?	V
Er det varmt ute	V
Ka e luftfuktigheta i dag?	N
Gi 2 av 6 poeng til A Tale of Time City	V
Spill musikk fra spillelista Get Your Mind Right	T
kan du gi mæ været for her?	T
Legg til sangen Nastya Kamenskih i The Martin Garrix Show-spillelista mi.	B
Ka er luftfuktigheten i dag?	V
Ka e d forutsette været for mitt nåværandes sted for neste måned ?	V
Finn et bilde som hette Wisconsin	V
sett alarm til 7:20 for skoutgivelsen	T
Kan du gi meg været for her	V
Skru alarm på før kl 6.	N
Vis mæ påminnelsan mine.	N
Slå av påminnelsan for imorra	T
Sett på ein alarm for klokkå seks i mårå	V
Ka e det spådde været for der eg e neste måned?	V
Læs mine påmindelsa.	N
Lægg tel den her sangen i min perfekte spælleliste før italienske middaga.	N
når kan eg se A Handful of Dust på kino	V
e det minusgrader idag?	T
Blir det bli sol i dag?	V
korr varmt e det?	T
Sett på ein alarm for klokkå seks på onsdag	V
Ka som e den nærmaste kinoen som har en film som starte om 90 sekunda?	N
legg te boka her fem stjerna	T
Æ har løst å se katti Silly Movie 2.0 at går på kino.	N
Kommer det til å bli kjøligere i Sinclair om 8 timer	B
Finn et bord for ein på ein populær churrascaria for tri ukår fra nå	V
Gi 0 poeng utav 6 te The Gate of Worlds	T
Finn ein kino som viser Life and Death	V
Ej vil høre på musikken fra Ghost in the Shell: Stand Alone Complex.	V
Skal det snø denne uka?	B
Koss kaldt komme d t å vær idag?	V
blir det å bli snøstorm på min nuværanes posisjon?	N
Ka e værmeldinga førr min nuværanes posisjon førr neste måned?	N
Bruk Groove Shark til å spille musikk fra åttitallet	B
Vis meg tvprogrammet Limit of Love: Umizaru	V
Ka e temperaturen i London akkurat no?	V
Jeg vil høre på en konsert av Timour Moutsouraev.	B
Legg te denne sangen te min dn perfekte italianske middagen spilleliste	T
Vis meg vermeldingå i Wisconsin	V
Spill nokka Mf Doom fra seksti-tallet på pandora.	N
skru av alle alarmer	V
Blir det å regne i dag?	N
Slå av alarmen min imorra tidlig	T
Vis meg TV-programmet Limit of Love: Umizaru	V
Ska det regn i dag?	T
Æ vill gje Half Lifte 3 av 6.	N
Fin filmalista før ArcLight Hollywood.	N
e d kaldt ute idag?	V
Ka e påminnelsene min?	V
Vis mæ værmeldinga for Wisconsin.	N
legg t cross bones stil t Guest List Take	V
fortell mæ når det vil bli varmar i Kina?	T
Blir det sol i dag?	V
Slumre alarmen.	V
Sett en påminnelse om å ringa skolen på mandag kl 16	V
finn Vegucated som starte klokka tolv	T
Vis meg værmeldingå for Wisconsin	V
Skru av påminnlesen om møte på hytta.	N
Hvordan skal været være i Bahamas om elleve år fra nå?	B
Gi meg ein påminnelse for boligovertaking kl 10 i mårå.	V
E vil gjerne hør på nokka 50-talls musikk	T
Avlys alramen for den her ettermiddagen.	T
Komme det te å bli vindfullt kl. 16 i NY?	V
Vis mæ alle påminnelsan.	N
Minn mæ på å lage lunsjen til han Dan klokka halv åtte i morra tidlig.	N
Vis alle alarma.	V
Kordan skal vere vere i Arizona på tredje oktober.	V
sett en alarm for 0615	V
finn filmtiden førr filma i nærheta	N
Kordan e veret dinna veka?	V
Mæ og imelda vil ha en reservasjon i Missouri klokka syv om morraen.	N
eg og imelda vil ha en reservasjon i Missouri kl 19	V
Endre morningalarmen i mårå te kl. 6.	V
Skru av alle alarmer.	B
Legg t et album av Joseph Meyer på POP GOES THE 80s-spillelista mi, vær så snill	T
Bruke Groove Shark til å spille musikk fra åttitallet.	V
skru av alarm	V
Skal det ver vind i dag?	V
Kor kan ej vinne The world according to Paris?	V
Finn the Ultimate Gift, tv showet.	V
Gi mæ en liste av filmtidan for filman i nærheten .	T
Ønsker å høre albumet Since I Saw You Last	B
Ska det vær sol imorra?	T
Sett en alarm for klokkå 5	V
Mirrorshades gir jeg tre stjerner	B
spille Tarzan of the Apes på Cobb Theatres	V
Blir vinden å gå over på mitt nuværanes plassering innen middagstid?	N
Førtell mæ værmeldinga førr Guinea-Bissau e du grei.	N
Ka e fuktighetsnivåe i dag	T
E treng en reservasjon til klokka 18, for en gruppe på 10 på Sand Lake	T
Spel musikk fra spillelistå Get Your Mind Right	V
vis bok navn Straight No Chase	N
Book en resturant som sververa agnolotti i Colerado City Idaho.	V
Sett på ein ny alarm for torsdag klokkå ett på ittemiddagen	V
Kan eg se kinoprogrammene?	V
Skal det blåse i dag?	V
ska det snø på torsdag?	T
Spill litt David Mallett på lastFm.	V
Når kan ej jså A handful of dust på kino?	V
gi mæ en liste av filmtidan te filma i nærheten	T
Bestill en tur for 3 til Virgin Islands i USA	B
Vis alle alarmer	V
Sett en alarm klokken 6 tidlig på ons	V
Vis meg alle alarmene	V
Hvor varmt kommer det til å bli i dag?	B
Kommer vinden te å stilna her eg e nå innen middagstid?	V
gi det essayet her 3 av 6 stjerna	T
Hvilke påminnelser har jeg?	B
Hvor varmt er det?	B
Søk ette Chasing Fortune a TV series .	V
Minn mæ på å kjøpe kaffe på Starbuck i ettermiddag	T
slå av alarm	T
Ka e tempraturn?	N
Book mæ en lunsj ved Boreas for 8 folk.	N
Kordan ska veret ver i Meeres-Nationalpark Insel Bastimentos klokkå tolv på dagen	V
skru av alarm	T
Spill litt Mf Doom fra sekstitallet på pandora.	V
Gje dette essayet to av seks stjerner	V
Kanseller alarmene.	V
Legg til et album av Joseph Mayer på POP GOES THE 80s spillelista mi.	V
Sett på en alarm for klokka 17	B
Sett en påminnelse om å ringe skoln kl 16 på mandag.	N
Vis alle alarman.	N
Finn en sang som e kalt The House of the Yellow Carpet.	N
e dt varmt ute	T
Kor varmt e det?	N
spill en låt fra 2004	V
hvilke alarma har æ på?	T
Skal det regne i helga?	V
Stacy Watson og Adriana vil dra te den beste osteriaen i Hallowell Minnesota i ittemiddag	V
Finn en kino med Life or Death.	N
E vil hør albumet Since I saw You Last	T
Ka e påminnelsene mine?	V
Kan du legge til en annen låt i klesvask-lista?	B
Bestill et bord hos Fairview i nærheten av området	B
E d fuktig idag?	V
Komme det te å bli kjøligere i Sinclair om 8 timer	V
Æ træng ikkje en paraply i mårra.	N
Skru av alle alarmer	V
put Do You Love Me til min akustiske soul lista.	N
Kor masse ska han rænge i mårra?	N
Skru av alle alarma.	N
Sett på en alarm hvert minutt i de neste 11 minuttene	B
Finn filmprogrammer for ArcLight Hollywood .	V
Kanseller påminnelsen min om å tekste pappa	V
vis alle alarma	T
Førtell mæ værmeldinga førr de neste tre dagan.	N
Sett en elleve-minutters alarm hvert minutt.	N
Kor kaldt ska det ver i dag?	V
Gi to av seks poeng te A Tale of Time City	T
Avslys alle mine påmindelsa.	N
Legg til Do You Love Me på akustiske soul spillelisten min	V
Si meg når det kommer til å bli varmere i Kina.	B
Ska det bli storm i dag?	V
Bli dt storma i Bordentown i dag	T
legg te sang te min Para comer	T
slett alle påminnelsa	T
vis alle alarman	T
Finn meg et bord for 8 ein plass i Hollenberg om ni uker	V
Finn Vegucated som starte ved midnatt.	N
Slå av alarmen min for imorra tidlig	T
Blir det å regne i dag?	N
Ska d bli sol i dag?	N
Sett på en alarm for klokka 6 på onsdag	B
skru av alarmen min for imårå tidlig	V
Reserver en topprangert osteria syv uker fra nå	V
Vis alle alarmer	V
Legg til Ashley McIsaac til r&b pary klassikera spillelista mi.	V
Skru av alarmen	V
Kommer det til å bli kjølig i Vest-Sahara om 13 timer	B
Gi 2 utav 6 poeng te A Tale of Time City	T
I vinter vil Meredith, Betty og Erika spise på en gastropub på samme sted som Fran er	B
Ka er fuktigheten i dag?	V
Skru av alle alarman	N
finn et fotografi som hette Between the Days	V
Kordan e været nærme Triumph	V
Ska det snø på torsdag?	V
legg t sang i Para comer	T
Sett på ein alarm te ti på halv åtta for å minna om skoslippet	V
Reserver en restaurant te mæ for ni i Statham	T
Førtell mæ kor det blir varmere i Kina.	N
ska det regn i dag?	T
Vis meg alle alarmer	V
spill Luis Alfonzo Larraín fra 1995	T
Burde æ ha på mæ kåpa i dag?	N
Komme det te å regna i dag?	V
Kan du gi me været for her?	T
kor varmt ska dt bli i dag	T
Slætt alle påminnelsa.	N
Komme det te å vær ein storm i nærheten	V
Gi The Art of Nijinsky 5 poeng	B
E det fokti i dag?	N
Sett en alarm førr klokka seks i morra tidlig	N
gi fem poeng t The Tenor Wore Tapshoes	V
Kor mange alarma he ej satt til søndag?	V
Minn meg på om å ringe mamma i dag klokka 14	B
Finn animerte filma på Caribbean Cinemas.	N
spel albumet Everybody Happy av Lee Aaron	V
book et bord til me og steonkelen min på Malta på en cafe	T
finn en restaurant i FM som servere quiche	T
Spill albumet Virbations av Marion Elise Ravn	B
Book en restaurant som servere agnolotti i Colorado city Idaho	T
Sett på ein alarm te klokkå seks om morningen	V
Ka han sei om være her?	N
Kordan skal veret vere på Bahamas elleve og et halvt år fra no av.	V
Koss e været i London?	T
Ka bli været i Meeres-Nasjonalpark Insel Bastimentos klokka 12?	T
Sla av alle påminnelsa	T
Æ vil se visningstidan for Silly Movie 2.0 på filmhuset	T
Ka film hus vise Flower and Snake kl 08:56:29 ?	T
Er det under 0 grader i dag?	B
Skru av alle alarmer	V
finn bilde Louder Than Bombs	T
Stopp alrmen før kl 6.	N
Ej vil ta me Shawn, Maguerite og della til en plass å ete nær Rwanda.	V
finn mæ filmtidan	T
skru av alle alarma.	N
når vise Sanktinos Teateran animerte filma?	T
Alarm på	V
sett alarm for kl. 6	V
Er det varmt ute?	B
Spæll sanga av Joseph Utsler.	N
Det albumet her får 3 av 6 poeng	T
Lægg tel Ashley McIsaa til min r&b party classics playlist	N
Fjern påminnelsen om møtet i lodgen?	B
Vis mæ påminnelsen min.	N
alarm på	V
Ka blir været å være i Bahamas om elleve og et halvt år?	N
Dt aktuelle albume får tre utav 6 poeng	T
bestill en reservasjon for syv stykk på The French Laundry åttende juni i 2029	T
Kommer vinden til å løye der jeg er nå før middag?	B
Legg til Armen Movsessian til ditta e skepta spillelista.	V
æ gir Hadon of Ancient Opar to av seks poeng	T
Legg denna sangen til i spillelista mi 70s smash hits.	N
Træng æ kåpa i dag?	N
Kommer det til å regne i dag?	B
Sett på en alarm for klokka sju i morgen	B
Æ harr løst tel å se visningstiden førr Sally Movie 2.0 på the movie house	N
spill 40-talls sanga	T
Vis mæ værmeldinga før 15:04 in Georgia før om det e skyat.	N
Book en resturang som servere angolotti i Colorado City Idaho.	N
Legg Jacob Hoggard til i Get going-spillelista mi	B
Gi fem poeng til The Tenor Wore Tapshoes	T
Vis alle påminnelsa.	V
Skru av alle alarmer	V
spill musikk på Lastfm	T
Komme d t å vær sol idag?	V
Vis alle alarmer	B
Når ska det regn idag?	T
Sett en alarm for 15 min.	N
Legg Kan Mikami i Pre-Party R&B Jams	T
Eg vil legge til dette albumet til funtime.	V
Legg til bright and breezy til Dette e Gucci Mane spillelisten min	V
finn animerte filma på Caribbean Cinemas	T
finn en kino med Life and Death.	V
æ ønske å hør albumet Since I Saw You Last	T
ska det snø idag?	T
Legg til en påminnelse om å svømme i morgen klokken 1100	V
Dette albumet får tre av seks poeng.	B
book et bord te meg og min ste onkel på en kafeteria i Malta	V
Bookn bord for 8 på et biffhus som servere sashimi.	N
Slå av alle alarma.	T
Finn et spæll som heite IBM Program temporary fix.	N
Legg til en booking førr seks persona på en restaurant i nærheta av Montana som servere Sri Lankisk mat på tirsdag.	N
Bli det snøstorm her e e?	T
Ka filmer e planlagt i nabolaget?	V
Slumre alarm	T
Vis meg alarmene mine.	V
Vis meg fotografiet Rock You Baby	V
legg denne artisten te min Jazz spilleliste	T
minn mæ på å kjøp melk ikveld	T
når ska Utamaro and His Five Women visas på Alamo Drafthouse Cinema	V
Vis alle alarman.	N
Slett alle påminnelsa.	N
vis alle påminnelsar for imårå tidlig	V
Kor varmt e d?	V
Vis alle alarma	T
Ska det bli kaldere i La Mesa?	V
Ska d være varmt i mårra?	N
Slå av min siste påminnelse	T
Sett en alarm klokka seks om morraen på onsdag.	N
Finn ein bar som severe pizza te seks stykk	V
Koss e fuktigheta i dag?	T
Spel shadowplay av Dana på Deezer.	V
Finn et bord te ein på en populær churrascaria i tre uker fra nå	V
Vurder dette essayet til 2 av 6 stjerner	V
Legg t bright and breezy til This is Gucci Mane-spillelista mi	T
Ska dt regne i dag?	T
Koss e været i London?	T
Ka e den nærmeste kinoen som vise filma som starta om nitten sekund.	V
Æ leite etter en plass å ta med Shawn, Marguerite og Dell for en plass nær Rwanda.	N
Vis meg påminnelsene mine	V
Slett alle påminnelser	V
Finn soundtacket som hette The House of the Yellow Carpet	V
Fjern alle påminnelsan mine	T
Legg til den noverende boka i fem stjerne.	V
Ska det regna denne helgå?	V
Spel den mest populære 20-årstallplatå fra Leland Sklar	V
Vis alle påminnelsa satt førr i morra.	N
For Mirrorshades gir æ dn tre stjerna	T
Koss e være nær Triumph	T
Spill Luis Alfonzo Larrain fra 1995.	B
Spill topp tjue sanga fra The Kleptones på Spotify	N
minn mæ på å kjøp melk i kveld	T
Korr kaldt ska det bli i dag?	T
sett alarm til klokka 6:30 i morra	T
Skal det regne i nærheten av der jeg er nå klokka 24:00?	B
Gi meg værmeldingen for de neste 3 dagene	V
Minn meg på å lukka huset klokkå ti i mårå	V
Kordan vil veret ver i Arizona tredje oktober?	V
Spill noe melodi fra åttitallet på Spotify	V
Når går de ulike filmene på Caribbean Cinemas?	B
avbryt alle alarma	T
kor mange cm med regn e det meldt imårå?	V
Slå på alarm til klokka 7 i morra	T
Slumr alle alarmer	B
reserver et bord for mæ og min steonkel på en cafe på Malta	T
Koss vil være vær om seks min nær Moosic	T
Kan du vise meg været her	V
legg til den sangen her til in the arms of a woman	T
Skru av alle alarma.	N
Komme eg t å trenga en jakka idag?	V
Spæll Luis Alfonzo Larrain fra 1995.	N
slå av alarm	T
Trenger eg jakke i dag?	V
Ka e neste ukes værmelding?	T
spell den beste Charles Neidich sangen for mæ	T
Vis frem From South Africa to South Carolina	V
Har eg ein påminnelse for tannlegetimen min?	V
bruk Groove Shark te å spell musikk fra åtti-tallet	T
Legg til bob klose til la mejor música para tus fiestas.	V
Skal det ver sol i dag?	V
Finn en trailer som hette Storm Center .	V
Stopp alarmen som er klokken 0600	V
Finn en kino som spilla Life and death.	V
Spill dn mest populære tjuetalls sangen fra Leland Sklar	T
Ska d rægne i dag?	N
Vis alle alarmer	V
Har å noen påminnelsa?	N
vennligst legg te et albm av Joseph Meyer te min POP GOES THE 80S spilleliste	T
Ka e vere i nerheden av Triumph	V
Ka påminnelsa har æ?	T
Korr kaldt blir det på morran?	T
Sett å påmindlese om at æ ska på svømming i mårra.	N
Ka han sei om værmeldinga før næste uka?	N
finn Vegucated fra kl 0.00	V
Finn Vegucated og begynn klokka tolv.	N
Eg vil gjerne se sagaen 12 Soulful Nights of Christmas	V
Spel den beste Charles Neidich sangen for meg	V
ska dt vær kjøli i Vest Sahara om 13 tima	T
Minn mæ på å sende inn timeplanen min hver mandag innen slutten av dagen.	N
Slumre alle alarma	T
Finn filmtidene for ArcLight Hollywood	B
Blir det å snø i morra?	N
Eg vill hørra på nage femti-tals musikk	V
Vær så snill å fortell meg værmeldingå for Guinea-Bissau	V
Les meg alle påminnelsene mine.	V
legg t den artisten her t jazz-spillelista mi	T
vurder den nåværandes bokå 3 stjerner	V
book en topp rangert osteria om sju veke	N
Vis alle påminnelsene mine.	V
Vis mæ alarman mine	T
Bli det storm i dag?	T
Slumre alarm	V
Ka e PW værmeldinga førr storm?	N
Skal det ver sol i dag?	V
Kor varmt blir det i dag?	V
ska det bli kjørligar i Sinclair om åtte tima?	T
minn meg på om bryllupet	V
reserver for 3 i U.S. Virgin Islands	V
Reserver en restaurant som servere agnolotti i Colerado City Idaho .	T
Spill av nokka av David Mallett på Last fm	T
sett en alarm i femten minutt	T
sett på alarm klokken 0600	V
Kanseller alle alarma.	N
Spill litt MF Doom fra sekstitallet på Pandora.Pandora er en musikkapp	B
Alarm hvert femte minutt i 20 minutta e du snill	N
Kor varmt e d?	N
finn et videospill som hette IBM Program temporary fix	V
Kanseller påminnelsen for møtet på hytten	V
Vurder dn aktuelle stilen te tre utav 6 stjerna	T
Lægg tel Nastya Kamenskih sang tel min The Martin Garrix Show spællelista.	N
finn animerte filma på Carribean Cinemas	T
Spel albumet Everybody Happy av Lee Aaron	V
Ka e temperaturen i London akkurat no?	T
Hva er luftfuktigheten i dag?	B
Lægg tel 70-talls slagere tel min.	N
Kor varmt e dt	T
Avlys alarman	N
Kjæm dt te å regne denne helga?	T
alarm på	V
Sett en påminnelse om at æ må ringe skolen min på mandafg klokka fire.	N
Sett på en påminnelse om å ringe skolen min på mandag klokka 16	B
finn Vegucated som starte vd midnatt	T
Vis meg værmeldingen for Wisconsin	V
Kjem ej til å trenge ei jakke i dag?	V
Ej vil legge til ditta albumet i funtime.	V
Ka e værvarselet for mitt nåverende sted neste måned?	V
Skal det regne i dag?	V
Ska det regna neste uga?	V
Legg te Ashley McIsaac i r&b party classics spillelistå mi	V
Spill musikk på Itunes.	V
sett en påminnelse for å ring skolen på mandag klokka 16	T
legg te Jacob Hoggard te min get going spilleliste	T
Minn mej på å kjøpe kaffi på Starbucks i ettermiddag.	V
Vis alle alarma.	N
Åpne spotify og spill en sang fra tjuetallet av Richard Harvey.	V
Ska det snø denne ugå?	V
e det under 0 grader i dag?	V
vis me TV-showet Limit of Love: Umizaru	T
Legg til Morten Harket til dette e puccini	V
Vennligst sett min alarm te klokka fire på morgen på lørdag	T
burda e ha paraply i dag?	T
Vis alle alarma.	N
Vis min påminnelse	T
Åpne spotify og spill en sang fra 20-tallet av Richard Harvey	V
alarm på	T
blir det å være kjølig i Vest Sahara om 13 tima	N
gi herre novellen en null av seks	T
Vis alle alarmer	B
Legg til Jacob Hoggard til get going spillelisten min	V
koss ska været vær uka her?	T
sett på alarm klokken 0600	V
Minn meg på bryllupet	V
Ka ti skal det stoppe å regne.	V
Kan du gi meg været herfra	V
Vær så snill å sett alarmen min for kl 4 om morran denne lørdagen	T
Det noverende albumet fer tre av seks poeng.	V
Legg denna sangen til i the perfect italian dinner spillelista mi	N
Vær så snill og si meg værmeldingen for Guinea-Bissau	V
gi den gjeldende boka tre stjerna	T
Ska det regne i helgen?	V
Finn et bord til meg for 8 personer et sted i Hollenberg om ni uker	B
Kor kaldt komme det te å bli i dag?	V
spel førstitalls sanger	V
Sett en alarm for klokken 5 i ettermiddag.	V
Sett en alarm for hvert tiende minutt, begynn 0530 og slutt 0600	V
Åpen spotify og spill en sang fra 20-tallet av Richard Harvey	T
Kommer det til å være en storm i nærheten?	B
Finn timeplanen for Ghost World.	V
Sett på en alarm kvart femte minutt for tjue minutt takk	V
Eg vil gjerne se visningstidene for Silly Movie 2.0 på kinoen	V
Spill en sang av Houston på Spotify.	V
Kommer det til å regne i helga?	B
Ka e spilletidene?	V
Slå av alarma for i morra tidli	T
Slumre alle alarman	T
Gi 0 poeng av 6 te The Gate of Worlds	V
Fortell mæ ka filma som spille på AMC Theaters akkurat no	T
Skal d rægne næste uka?	N
Komme vinden t å dø ned på mitt nåværandes sted innen middagstid?	V
påminn meg å ringe mamma i dag klokken 2.	V
finn et fotografi som heter Between the Dats	V
Book et bord for 10 personar på en restaurant som tilbyr internett .	V
Kor varmt skal d bli i dag?	N
æ treng et bord for fire på en restaurant rundt klokka tolv på kvelden	T
Kor kan eg finna The World According to Paris ?	V
sett på alarm 0615	V
finn et foto kallt Between the Days	T
Finn en trailer som heite Storm Center.	V
Ej gir Hadon of Ancient Opar to av seks poeng.	V
Hvis meg påminnelsene mine	B
Kordan alarma har æ satt?	N
Plis sett alarmen min på te klokkå 4 denna lørdagen	V
Finn e resturang i FM som severe quiche.	N
Eg ser itte ein plass eg kan ta med Shawn, Marguerite og Della for spisa nærme Rwanda	V
SKa han rægne i dag?	N
På trettende mai, 2037, kordan vil det være i Wilderville, Montenegro	V
Skru av alarm.	B
Gje A Tale of Time City to av ti poeng.	N
Sett på ein timer på 15 minutter	V
Kanseller alle alarmer	V
Skru av alle alarman.	N
Find nærmeste kino som viser Operation: Kingdom	B
finn et video spill kallt IBM Program temporary fix	T
Ej vil booke en restaurant.	V
Finn en reservasjon for tre på en topp rangert restaurant	V
sett en alarm førr klokka seks om morran	N
Slumre alle alarmene mine.	V
sett Do You Love Me på akustisk sjel spillelista mi	T
Jeg vil gjerne legge til dette albumet til Funtime	B
minn mæ på å lag lunsjen te Dan kl 7:30 i morra tidli	T
Sætt alarmen før kl 7 i mårra.	N
søk på Chasing Fortune en TV serie	T
slett alle alarma	T
Vis alle påminnelser for i mårå	V
Ka er neste ukes værmelding?	V
Legg t Jacob Hoggard t Get going-spillelista	T
Kor kaldt vil det vær på morningen?	V
Bestill bord på en restaurant nær Montana som serverer Sri Lankisk mat for 6 personer som har gode anmeldelser på tirsdag.	B
Fortell me om når det bli varmar i Kina	T
Kor varmt e dt?	T
Sett ein alarm for kvert tiende minutt, som starte kl. 5:30 og slutte kl. 6	V
Kordan ska veret ver om seks minutt rundt Mossic	V
Eg vil legga te dette albument i funtime	V
vis alle alarmer	V
komme d t å regna idag	V
Legg te Ashley McIsaac te r&b party classics spelelistå mi	V
Vis meg fotografiet Rock You Baby	B
Vis meg påminnelsen min	V
Les opp alle påminnelsene mine	B
Finn mej et bord for åtte en plass i Hollenberg om ni veke.	V
Kommer vinden til å gi seg der eg e ved middagstid?	V
Minn mej på å stikke til tannlegen neste mandag.	V
Reserver bord på ein restaurant te ni stykk i Statham	V
finn lydsporet som hete The House of the Yellow Carpet	N
Hva er temperaturen i London akkurat nå?	B
legg te dn aktuelle boka fem stjerna	T
Finn serien The Ultimate Gift	V
Fortell meg ka filmer som vises nå på AMC kinoene.	V
E tannlegetimen min i påminnelsen ?	V
Minn meg på at eg må smøra nista te Dan halv åtta i mårå tidligt	V
Sett en alarm hvert tredje minutt.	N
Ka filma e planlagt i nabolaget ?	N
Lægg tel Armen Movsessian tel den her skepta spællelista.	N
ska det vær snøvær på den nåværende posisjonen tredje mars?	T
vis mæ værmeldinga for Wisconsin	T
legg Jacob Hoggard te get going spillelista mi	T
Hvor fuktig er det i dag?	B
Gi mej ei liste med spilletidene til filma i nærheten.	V
legg te Do You Love Me te min akkustisk soul spilleliste	T
Kommer det til å være snø på nåværende posisjon innen 3. mars?	B
Legg til sangen til Para comer.	V
Skru av alle vekkerklokker	B
ska dt snø i dag	T
vis meg påminnelsene mine	V
Komme vinden te å avta på min nåværende plass innen kveldsmat tid?	V
Ka slaks klea har æ før vere?	N
vis fram Fra Sør Afrika te Sør Carolina	T
Ka e mine påminnelsa.	N
Speil ablumet Vibrations av Marion Elise Raven	V
Ka alarmer har eg på?	V
Spill en sang av Juanes på Last Fm	T
legg Do You Love Me til i my acoustic soul spillelista	N
Skal det ver sol i mårå?	V
Vis me alarman mine	T
Skal det regne neste veke?	V
avbryt påminnelsen for møtet på hytta	T
minn meg på å levera inn undervisningsplanene mine kver mandag på slutten av dagen	V
Er det kaldt i dag?	V
Vilken e dn nærmeste kinoen som vise filma som starte om nitten sek ?	T
fjern alle alarmer som er satt på	V
Legg til Armen Movsessian til dette e Skepta spillelisten.	V
Legg til dinna sangen til det perfekte italienske middagselskapet spillelista mi.	V
E vil gjerne legg til det albumet her til morotid	T
Spel någe Mf Doom fra sekstitallet på pandora	V
Ka e påminnelsene mine?	V
Finn en tvserie som hette Church of the Truly Warped .	V
sett alarm for kl 6:15 om morran	T
Komme d t å bli kaldere i Sinclair om 8 timer	V
legg til denne boken til fem stjerner.	V
Legg til sangen til min Para comer.	V
sett på en alarm om femten minutter	V
Legg te Bright and breezy te spelelistå mi This Is Gucci Mane	V
Kanseller påminnelsen min om å sende melding til han Pappa.	N
Blir det å snø denna uka?	N
gi null av seks poeng te The Gate of Worlds	T
Skru av alarmen.	V
Kanseller alle påminnelsa.	V
Bruke Groove Shark for å spælle musikk fra 80-talle.	N
Ranger ditta essayet tre av fem stjerne.	V
Reserver for 7 personer på The French Laundry 8. juni, 2029	V
Ka for någen filmår vises på AMC Theaters?	V
Legg til dette albumet i dubstep dangles dirty-spillelista mi	B
Ka e vermeldingå i Guinea-Bissau?	V
Vis mej Happiness was free.	V
Kor mang alarma har æ satt for søndag?	T
Slå av alle alarma	T
Vurder det nåværandes essayet tre av 6 stjerner	V
Vis tittel på bok Straight No Chase	V
Bestill et bord for meg og steonkelen min på en kafeteria på Malta	B
Kordan e veret denne ugå?	V
Sett alarm for kl. 5	V
Sku av alle alarmer	V
reserver en topp-vurdert osteria sju uka fra no	T
e det varmt ute	V
Kommer det til å bli varmt i dag?	B
Gi den aktuelle romanen en vurdering på 3 av 6.	V
Kass filmhus vise Flower and Snake klokkå 08:56:29 ?	V
Eg vil hørra på musikken te Ghost in the Shell: Stand Alone Complex	V
burde eg ta me meg en paraply idag	V
Legg denna sangen te spillelistå mi den perfekte italienske middag	V
Åbna Spotify og spel ein sang fra tjue-talet av Richard Harvey	V
Ka kommer været til å være i Meeres-Nasjonalpark Insel Bastimentos midnatt	V
Ka e nedbørsvarselet for stormfullt ver?	V
sett på alarm til klokka 5 i kveld	T
Finn TV-serien som heter Church of the Truly Warped.	B
Legg bright and breezy te This Is Gucci Mane spillelista mi	T
Eg vil gi Half a Life 3 av 6	V
Avbryt alarm for imårå tidlig	V
Sett en alarm hvert minutt i 11 minutter	V
Hvordan blir været for området jeg er i nå neste måned?	B
Finn bilde Adventure Time: The Secret of the Nameless Kingdom.	N
E det under frysepunktet i dag?	V
Slett alle alarmer	V
denne vinteren så vil meredith, betty og erika spisa på ein gastropub som ligge i samme område som frans beliggenhet.	V
Ka e neste vekes værmelding.	V
Spill de mest spilte sangan av Joseph Utsler.	N
Ska det snø denne uken?	V
Gi den boka her tre stjerna	T
Ka er vermeldingå for de neste fem dagene?	V
reserver en restaurant for ni i Statham til meg	V
Ka komme varmeindeksen t å vær idag?	V
legg Jacob Hoggard til i get going spillelista mi	N
Sei meg når det vil vær varmare i Kina	V
Finn ein serie som hette Chruch of the Truly Warped	V
Slumre alarmen	V
Book en restaurant førr 7 persona på The French Laundry den 8. juni.	N
Kanseller alle påminnela.	V
Vis mæ værmeldinga førr Wisconsin.	N
Gi tre av seks stjerne til My Sister.	V
Kommer d tel å være kaldt i vestre sahara om 13 tima?	N
Vis alle alarman.	N
kor varmt ska det bli i dag	V
Skru av alle påminnelsene mine	B
været i Tioga Colorado	V
Komme d t å vær en storm nærme	V
Spel førti-tals musikk	V
Minn mæ på å dra til tannlegen neste mandag.	N
Vis mej ei bok som heite Straight no chase.	V
Søk opp tv-serien Chasing Fortune.	B
Spill av en melodi fra åttitallet på spotify	T
Slummre alarm.	N
bestill The Halal Guys te søttende oktober	T
Ranger ditta essayet 2 av seks stjerne.	V
Finn et fotografi fra Adventure Time: The Secret of the Nameless Kingdom	B
Vis mej alle alarma.	V
Skru av alarmen.	N
Vær så snill å put enda en låt te klesvask spillelista.	T
Legg til Ashley McIsaac til r&b classics spillelista mi	N
Les opp alle mine pååminnelsa.	T
Vis From South Africa to South Carolina	N
Slå av den siste påmindelsen.	N
Book mæ en restaurant førr ni i Statham	N
Alarm hver femte minutt for tyve minutt takk	T
Korr kaldt blir det idag?	T
burde æ ha på en jakke idag?	T
Avslys alle mine påminnelsa.	N
Sett alarm for klokka halv sju i morga.	V
Æ vil gje boka 3 stjenre.	N
Sett alarmen t kl 07:20 for skoutgivelsen.	V
Æ vil legge detta albumet til i funtime.	N
Fjern alle påminnelsa	N
Gi 2 av 6 poeng til A Tale ogf Time City	T
Les opp påminnelsan mine.	T
Ej vil høre på albumet Since I saw you Las,	V
Når skal det regna i dag?	V
Kanseller påminnelsen min om møtet på hytta.	V
Vurder The Art of Nijinsky 5 poeng	V
Book en restaurant klokka seksten i SC	N
Vis alle alarma.	V
Legg til cross bones style til Guest List TaKe	V
Sett på en alarm klokken 0500	V
legg dette albumet te i min dubstep dangles dirty spilleliste	V
Æ gjer 5 poeng tel The Tenor Wore Tapshoes .	N
Kjæm dt te å vær kjøligere i La Mesa ?	T
Katti vil Santikos Theatres vise animerte filma?	N
Ska det ver snø her før tredje mars?	V
Skru av alle alarma.	V
når kan æ se A Handful of Dust på et film teater	T
ska det bli kaldar i Sinclair om 8 tima?	T
vis alle påminnelser for i mårå tidlig	V
Legg til Armen Movsessian i This is skepta-spillelista	B
Sett to alarma i morra tidlig.	N
E dt kaldt i dag?	T
Vises Tarzan of the Apes hos Cobb Theatres?	B
Ka e påminnelsan mine?	N
Finn et bord for en på en populær churrascaria tre uker fra nå	V
legg denna nåværandes bokå t fem stjerner	V
ka e værmeldinga her førr kaldere temperatura om atten minutta	N
spell litt Mf Doom fra seksitallet på pandora	T
Hva er værmeldingen klokka 15:04 i Georgia når det gjelder om det er overskyet i Valley View	B
Vis påminnelsen min	B
Eg gir Hadon of Ancient Opar to av 6 poeng	V
minn meg på å kjøpa melk i kveld	V
Kanseller alarmen.	V
Bli det vind klokka 4 i NY?	T
Kjæm dt te å vær my vind kl 16 i NY ?	T
Blir det å bli varmt i dag?	N
Skru av alle påminnelsene mine	B
Trenge eg ein kåpe i dag?	V
vis bok navn Straight No Chase	V
Reserver et bord for 10 personer på ein restaurant som tilbyr internett.	V
Åpne Spotify å spill en sang fra tjuetalle av Richard Harvey	T
Plis putt et album av Joseph meyer på min POP GOES THE 80s spillelista	V
Finn tidsplanen til Ghost World.	V
sett på en alarm på 15 minutt	V
Vis alle alarma	T
Korr mange alarma har æ på på søndag?	T
legg te sangen her te min i arman av en kvinne	T
Sett ein alarm for kvert minutt i 11 minutter	V
Gje meg ei lista av visningstidene te filmer i området	V
Skru av alle påminnelser	V
Sett en alarm klokka halv sju i morra tidlig.	N
Sett en alarm for 06:30 imårå.	V
Finn ut katti filman går.	N
ska det regn den helga her?	T
kor varmt ska dt vær i dag	T
Skru av alarmene mine for i morgen tidlig	B
vis alle alarma	T
Finn en reservasjon for et vertshus som servere pizza for en gruppa på 6	V
Åpne Spotify og spel ein sang fra tjuetallet av Richard Harvey	V
Bestill et bord for 7 personer hos The French Laundry 8. juni, 2029	B
Lag ein påminnelse om at mamma kommer på besøk neste uga	V
reserver ein topprangert osteria syv uker fra nå	V
Jeg trenger en alarm for klokka 17 for å minne meg på om å ta medisinen min	B
Minn meg på å ringa mamma i dag klokkå to i ittemiddag	V
Legg te Jacob Hoggard te spelelistå mi Get going	V
Lægg tel et album av Joseph Meyer på min POP GOES THE 80s spællelista.	N
Finn et bord førr én på en populær churrascaria om tre veke	N
Kortid ska det regne i dag?	V
Finn filmtiden førr ArcLight Hollywood .	N
Sett ein påminnelse for å ringa skolen min på mandag kl 16	V
Kordan skal veret vere om seks minutt nær Moosic.	V
kanseller alle alarmer	V
På den trettende mai	N
Gi denne stilen 2 av 6 stjerner	B
Vil han komme med en strom i nærheita.	N
vises Tarzan of the Apes på Cobb Theatres?	T
Spill musikk på Lastfm	N
Vis påminnelsen min	V
Ka alarma he ej satt?	V
Kor varmt e det?	N
Ska dt bli sol i morra?	T
Ka blir varmeindeksen å være i dag?	N
Skru av alarmen.	N
Æ vil finne showe From Where to Eternity .	T
Kor varmt er det?	V
Ka e kinoprogrammene	V
lag en reservasjon for 1 dn 17. mars	T
sett ein alarm for kvert 3 minutt	V
Å træng en påminnelse før å plokke opp Lisa.	N
Kommer det til å blåse mye i dag?	B
Slå av alarmen imorra tidlig	T
Finn en reservasjon for tre på en topprangert restaurant	T
Søk opp Chasing Fortune tv-serie	V
Kommer det til å snø i dag?	B
Kanseller alarmen min i morra tidlig.	N
E det minusgrader i dag?	V
spell toppsangan te Joseph Uysler	T
Spill gode låter av Joseph Utsler	B
Trenger eg paraply i dag?	V
Skru av alle alarmene.	V
Finn filmtidene for Marcus Corporation.	B
Korr varmt e det?	T
Avlys alle påminnelsa	T
Ka e PW-værmeldinga for storm?	T
Æ vil ha et bord for 4 med for en resturang rundt midnatt.	N
Komme d t å bli kaldere i La Mesa ?	V
Kan du fortelle meg værmeldingen for stedet jeg er nå	B
spel Fereydoun Farrokhzad beste spor	V
Kor varmt e det?	V
Eg vil hørra på a concerto fra Timour Moutsouraev	V
Æ har løst å høre på musikken Ghost in the Shell: Stand Alone Complex.	N
korr kan e finn The World According to Paris?	T
Vis meg påminnelsene mine	B
E det varmt ute?	N
Legg til en påminnelse om å svømme klokka elleve i morga.	V
kanseller alarmen min for i mårå tidlig	V
Vis meg alle alarmene	V
Ska d regna idag?	V
æ træng en påminnelse te å plukk opp Lisa	T
slå av alarma for i morra tidli	T
Spill musikk fra spillelistå Get Your Mind Right	V
Ka e visningstiden på Caribbean Cinemas?	N
æ hadd gitt Half a Life tre av seks	T
finn kinotidene til meg	V
Slå av alarmen min på lørdag	T
Blir det å regne neste uke?	N
finn sang med tittel The House of the Yellow Carpet	T
Vis alle alarman.	N
Avlys alle påminnelsa	T
Sett på en alarm for femten minutter fra nå	B
stacy watson og adriana vil dra t det ebste osteriet i Hallowell Minnesota i ettermiddag	T
sett alarm for kl 6 om morran	T
Finn meg The Twinkler som spiller på National Amusements om 2 minutter	V
Eg vil gjerna se sagaen 12 Soulful Nights of Christmas	V
Vis mæ alle påminnelsan for i mårra.	N
Skru av alle alarmer.	V
Finn kinotidene	V
Ka sei han om at d ska bli storm?	N
Jeg trenger en påminnelse om å hente Lisa	B
Træng æ ei kåpa i dag?	N
Kordan filma e d som vise Flower and Snake kl 08:56:29 ?	N
e det kaldt i dag?	T
Slett alle alarma	T
Detta albumet får tre av seks poeng.	N
Legg t Ashley McIsaac t r&b party-klassikera spillelista mi	T
Komme det te å bli sol i dag?	V
Hvor mange millimeter regn skal vi få i morgen?	B
legg denna artisten t i min Jazz spillelista	V
Finn en reservasjon for tre på en topprangert restaurant	V
Æ treng en påminnelse om å plukke op Lisa	N
Skru av alarmen	V
Finn lydsporet som hette The House of the Yellow Carpet	V
Ka e det forventa veret her neste måned.	V
Vis mej vermeldinga for Wiscondin.	V
Ka er vermeldingå om åtta minutt for her når det gjelder kaldere temperaturer	V
På 13 mai,2037 kordan vil det være i Wilderville , Montenegro.	N
vis alle påminnelser	V
Ska det regn idag?	T
Kor mange millimeter regn skal det komma i mårå?	V
Legg te sangen 70s smash hits te	V
Æ har løst å se the saga 12 Soulful Nights of Christmas.	N
Kan du gje mæ værmeldinga førr her	N
Når ska Santikos Theatres vise animerte filma	T
Æ treng en reservasjon klokka 18 førr 10 persona i Sand Lake	N
minn meg på å lage Dan sin lunsj klokken 0730 i morgen	V
Gi meg værmeldingen for de neste tre dagene?	B
Slett min siste påminnelse	B
Legg til denne sangen til min i armene til en kvinne	V
legg te bob klose te la mejor musica para tus fiestas	T
trenge eg ein paraply i mårå	V
Gi to av seks poeng til A Tale of Time City.	V
alarm på	V
Eg vil høre på en solokonsert av Timour Moutsouraev	V
Book et bord for mej og ste onkelen min i Malta i kafeteriaen.	V
Søk på Chasing Fortune en TV-serie	V
Legg te Do You Love Me the min akustiske spelelista	V
minn meg på bryllupet	V
eg vil gjerne se sagaen 12 Soulful Nights of Christmas	V
Ska det vær storm idag?	T
Hvordan er været i London?	B
Finn kinotidene t meg	V
Når bler det varmere i Kina	V
Se om Life and Death e på kino.	N
Det nåværandes albumet får tre av 6 poeng	V
Vis fram From South Africa to South Carolina	V
E det kaldt ut?	T
Vis mæ alarmen min.	N
vis alle alarma	T
Ska d vær sol idag?	V
Skur av alarmen før i ettermiddag.	N
Slå av alarman mine før søndag.	N
gje tre stjerne / 6 til My Sister	N
Endre morradagens alarm til klokka seks.	N
en en alarm for femten minutt	T
Ska det ver snøstorm her eg e nå?	V
spill Fereydoun Farrokhzad sin beste sang	V
Blir det sol idag?	T
Sett en alarm for kvart tiende minutt, som begynner klokka halv seks og slutter klokka seks.	V
Burde eg ha på meg ein kåpe i dag	V
Lag ein ny alarm for torsdag kl. 13.	V
Sett på en påminnelse for besøk fra mamma neste uke	B
Koss vil været vær nærme Moosic om 6 min	V
Er det kaldt ute?	V
Sett en alarm te klokka fem	T
Komme det te å regna på lørdag?	V
reserver en topprangert osteria sju uka fra no	T
Ka e temperaturen akkurat no.	V
gje mæ en liste med filmtide førr filma i området .	N
finn en låt med titteles The House of the Yellow Carpet	V
Åpne Spotify og spill en sang fra tjuetallet fra Richard Harvey	B
Endr alarmen for i morgen tidlig til klokka 6	B
Komme d t å snø imårå?	V
Skru av alle alarmer	V
Kortid ska det regne?	V
Gje mæ en påminnelse på at huse stænge kl 10 i mårra.	N
sett en alarm for hvert tiende minutt, som bynne halv seks og slutte klokka seks	T
finn Vegucated, start 1200	V
I vil reservere for 10 folk kl 18 med Sand Lake.	N
e det kaldt ute i dag?	V
book t 3 i U.S. Virgin Islands	V
finn en restaurant i FM som servere quiche	T
Gjer 3 stjerne / 6 til My Sister,My Love	N
spill en sang fra 2004	T
Sett en påminnelse om at ho Mamma kommer på besøk neste uke.	N
Komme det te å snø på det nåværende stedet innen tredje mars?	V
Finn den nermaste kinoen som viser Opeartion: Kingdom	V
bestill nærme Montana restaurant som servere sri lankisk mat t 6 som e høgt rangert på tirs.	V
Spill en eller annen melodi fra åttitallet på Spotify.	B
Katti vise dæm filma på Caribbean Cinemas.	N
ska det regn i helga?	T
kanseller alarmen	V
Har eg noen påminnelser på?	V
Kan æ få se filmtiden?	N
sett Kan Mikami på Pre-Party R&B Jams	T
Vis mæ Happiness Was Free .	N
ha på en alarm for hver tredje minutt	T
Vis meg påminnelsen	V
Slett alle påminnelser	V
Ska det regna neste uke	V
Kanseller den siste påminnelsen min.	N
E det kaldt ute?	V
Ka filma spilla i nærheten?	V
E det skya ute i dag?	N
sett ein alarm for kl. 7 i mårå	V
kanseller alarmen min i morgen tidlig	V
Har jeg noen påminnelser på?	B
Slå av alle påminnelsan	T
Spill låter fra førtitallet	B
Avlys huskelista før i mårra.	N
Kommer det til å bli sol i dag?	V
stopp alarmen for klokka 6	T
Korr mange alarma har e på for søndag?	T
Si meg kortid det blir varmere i Kina	V
Æ vil gje roman 3 av 6.	N
Legg Kan Mikami til i Pre-Part R&B Jams	B
Minn meg på om å gå til tannlegen neste mandag.	B
Slumre alle alarmer	V
Finn en trailer som heter Storm Center	V
kor mange milimeter med regn ska det bli i mårå?	V
Burde å ha på jakke i dag?	N
Vis meg alle påminnelser	V
Skru av alarmen	V
Når kan e sjå A Handful of Dust på en kino?	T
spell albummet Vibrations av Marion Elise Raven	T
Slumre alarman.	N
Vis alle påminnelsene for imårå	V
ska det snø i morra?	T
Spill nokke musikk fra åttitallet på sporify.	V
Finn filmplanen for Marcus Corporation .	V
Vær så vænnli å sett alarmen for kl 4 på søndag.	N
Spill den beste Charles Neidich sangen til meg	V
Legg morten harket te dette e puccini	T
E påminnelsen min om tannlægen i mi lista?	N
vis alle påminnelsa for i morra tidli	T
været i Tioga Colorado	N
Kor fuktigt e det i dag?	V
spille Tarzan of the Apes på Cobb Theatres	V
Finn bildet Louder Than Bombs	V
finn et bilde som hete Between the Days	T
skru av alarm	T
spilles Tarzan of the Apes på Cobb kinoer	V
spel Luis Alfonzo Larrain fra 1995	V
Vis alle alarmer	V
når komme det te å stoppa å regna?	V
Trenge eg paraply i dag?	V
Kordan vil været være om seks minutter nærme Moosic	V
Jeg trenger en reservasjon for klokka 18:00 for 10 personer hos Sand Lake	B
Book en reservasjon førr én søttende mars.	N
Find en kino som spiller Life and Death	B
Spill en sang av Juanes på Last Fm	V
Spel den beste sangen te Fereydoun Farrokhzad	V
Kanseller påminnelsen min om å tekste pappa.	V
Vis meg Happiness Was Free.	V
kor varmt ska d vær idag	V
Trenge ej ei jakke i dag?	V
finn et fotografi som hette Between the Days	V
Kjem vinden t å ro se ned her e e ved middagstid?	T
Bestill bord til meg for lunsj på Boreas for 8 personer	B
Fjern alle mine satte alarma.	T
ska det vær varmt imorra?	T
Vær så snill å legg te et album av Joseph Meyer i min POP GOES THE 80s spilleliste	V
E tannlegetimen min i påminnelser?	V
vis alle alarma	T
Ke e værmeldinga førr neste uke?	N
Ka kino viser Flower and Snake klokkå 08:56:29?	V
Kor kald ska han være i mårra?	N
Sett alarmen for kvært tredje minutt.	N
Gi meg en påminnelse for boligovertakelse i morgen tidlig klokken 10	V
Ka e vermeldinga om atten minutt for kaldere temperatura.	V
Finn lydsporet som heter The House of the Yellow Carpet	B
sett en alarm for kvart over seks	T
Sett en alarm for klokka 6 i morga.	V
Skru av alarmen.	B
Ej skulle gjerne sett saga 12 Soulful nights of Christmas.	V
Les opp påminnelsene mine.	V
Sett alarm for kl 5 om morran	T
Kommer det til å bli fint vær i dag?	B
Ka e været like ved Triumph?	T
Alarm på.	N
Har eg någen påminnelser?	V
Æ træng å sette på en alarm 05:00 for å minne mæ på å ta medisina.	N
stacy watson og adriana har lyst te å dra te den beste osteriaen i Hallowell Minnesota denne ettermiddagen	V
Ka komme været t å vær i Arizona den 3 oktober	V
Skal d bli sol i dag?	N
Legg Ashley McIsaac til i R&B pary classics-spillelista mi	B
Finn ein trailer som hette Storm Center.	V
Kommer det til å bli kaldere i Sinclair om 9 timer	V
Gje to av seks poeng te A Tale of Time City	V
Endre alarmen for i morga tidlig til klokka 6.	V
Førtell mæ ka filma som spille nu på AMC Theaters	N
ska det regn på lørdag?	T
Vis min påminnelse	T
Kan du gi meg værmeldingen for Guinea-Bissau?	B
Vil d være strom i Bordentown i dag?	N
Fjern alle alarmene som e satt.	V
Sett en alarm for klokkå 6 imårå	V
Kor varmt e d	V
korr varmt e det?	T
Kommer det til å regne i dag?	B
Vis meg værmeldingen for Wisconsin	B
Finn ein restaurant te sju stykk på The Fench Landry åttende juni 2029	V
Blir det å bli kaldar i La Mesa ?	N
Eg trenge et bord for 4 hos ein restaurant rundt klokkå tolv.	V
Sett på ein alarm te klokkå fem i ittemiddag	V
Minn meg på å kjøpe melk i kveld	B
E det kaldt i dag?	V
E dt fukti ute?	T
Vis alle alarman.	N
Slumre alle alarma	T
Finn e lista over filma som vises i nærheita av mæ.	N
Finn en kino nærest mulig som vise Operation: Kingdom.	V
sett på alarm til klokka 6	T
gi essayen her to av seks stjerna	T
Slå av alle alarma	T
Spill operamusikk på google music	V
finn et bilde som heite Between the Days	T
Ska det bli kaldar i La Mesa?	T
Vis meg Happiness Was Free	V
Vis meg værmeldingen for Wisconsin	V
Spæll noen sanga fra 80-talle på Spotify.	N
Ska det ver kjøligt i vest Sahara om tretten timer?	V
Vær så snill og sett på en alarm 4 i natt på kommende lørdag.	V
E tannlegetimen min i påminnelsen min?	V
Spill en sang av Juanes på Last Fm	N
Finn timeplanen for Ghost World.	V
Ska dt regne nest uke	T
kati klokka vises Utamaro and His Five Women på Alamo Drafthouse Cinema	N
Spill noe Mf Doom fra sekstitallet på pandoraen .	V
Spel sangene te Joseph Utsler som e på topp	V
Minn mej på bryllupet.	V
finn et film teater m Life and Death	T
legg denne låta te min in the arms of a woman	T
Legg Ashley McIsaac te r&b party classics spillelista mi	T
ska det regn i dag?	T
Spill noe Mf Doom fra sekstitallet på pandora	V
Sett en påminnelse for mammas besøk neste uke	V
Skru av alarmen.	N
bestill en reservasjon for 1 på 17. mars.	V
Skal det storme i Bordentown i dag?	V
Gi null av seks til The gate of worlds.	V
Eg trenge ein alarm te klokkå fem for å minna meg på å ta medisinen	V
Kortid ska det stoppe å regne	V
Spill musikk fra spillelista Get your mind right.	V
reserver en restaurant for ni i Statham for mæ	T
legg te denne nåverende bokå fem stjerner	V
træng æ en paraply i morra	T
Vær så snill å sett alarmen min for kl. 4 denne lørdagen.	V
Slumre alarmen	B
book et bord i Fairview-nabolaget	T
E dt kaldt ute?	T
sett en alarm te klokka fem ikveld	T
Legg te Armen Movessian te spelelistå This is skepta	V
Sett på to alarmer for morningen i mårå	V
Spill Leland Sklars mest populære album fra tjuetallet	B
minn mæ på å ring mamma i dag kl 14	T
Eg sko hatt et bord te fira på ein restaurant rundt midnatt	V
Lag ein påminnelse om å gå på butikken seinere	V
Vær så snill og legg til en til sang i klesvask-spillelisten	V
Legg til en til sang i klesvask spillelista mi e du snill.	N
Gi mej en påminnelse om hus signeringa klokka 10 i morga.	V
Ka kino vise Flower and snake klokka 08:56:29.	V
Kommer det til å være en storm i dag?	B
Book et bord førr ti støkka på en restaurant som tilbyr internett.	N
Vis mej alle påminnelsene for i morga.	V
Lag en ny alarm til torsdag klokka ett.	V
Fortell meg hvilke filmer som vises nå hos AMC Theaters	B
Finn mæ et bord før 8 i Hollenberg om 9 uke.	N
Komme d t å blåsa kl 16 i NY ?	V
komme d t å bli kaldt i Western Sahara om 13 timar	V
Avslys alle alarmen.	N
Finn animerte filma på karibiske kinoa	T
Kanseller den siste påminnelsen min.	V
Finn timeplanen for Ghost World.	V
Ka blir været å være i Meeres-Nationalpark Insel Bastimentos klokka tolv?	N
Vis alle påminnelser for i morgen tidlig	B
været i Tioga Colorado	T
Finn et bilde av han Louder Than Bombs.	N
Finn en kino nærmest mulig som vise Operation: Kingdom	N
sett en alarm klokka seks onsdag morgen	T
Komme d t å regna denna helgå?	V
Kordan blir været denna uka?	N
reserver nærme Montana restaurant som serverer sri lanka mat for 6 som e høyt vurdert på tirs.	V
kommer det til å være storm på posisjonen min	V
Speil ein sang av Juanes på Last Fm	V
Ka slaks filma vise dåkker?	N
E det overskya i dag?	V
Minn mæ på å dra te tannlegen neste mandag.	T
Finn animasjonsfilmer på karibiske kinoer	V
Vis påminnelsen min	V
Ka e temperaturen i London akkurat no?	T
Spill albumet Vibrations av Marion Elise Raven	V
alarm på	V
slå av alle påminnelsa	T
Book mæ et bord i kantina før mæ og steonkeln min i kaffeterie i Malta.	N
Kanseller alarmen for i mårå tidlig	V
Træng æ en jakke i dag?	T
Book på The Halal Guys den 17. okt.	N
Avbryt min siste påminnelse	V
Dennan vinteren vil meredith, betty og erika spise mat på en gastropub som e på samme plass som fran.	N
Ka vil være i Bahamas være om 11,5 år?	N
Vær så snill å sett ein annen melodi på spillelisten for klesvask	V
Gi 0 av 6 poeng til The Gate of Worlds	T
vis meg påminnelsane mine	V
Blir det å bli sol i morra?	N
Skru av alarman før i mårra.	N
Finn spilletidene for filma i nærheten.	V
Legg til sang 70s smhas hits til min	T
Spæll sanga fra 40-tallet.	N
e vil sjå tida for Silly Movie 2.0 på kinoen	T
Ka filma e planlagt i nabolage ?	T
Æ har løst tel å å høre på konsert av Timour Moutsouraev.	N
Vis alle alarma.	N
Ka ska varmeindeksen bli i dag?	T
Slå av alarmen for klokkå seks om morningen	V
book ein topp rangert osteria sju uker fra nå	V
Kor varmt e d?	N
Kanseller alle påminellser	V
Sett en alarm klokken 19:20 for skolanseringen.	V
Ska det vær sol idag?	T
Eg ønske å ta me shawn, marguerite og della t en plass å spisa nærme Rwanda .	V
stacy watson og adriana ønske å gære tel den beste osteria i Hallowell Minnesota i kveill.	N
Æ e ute etter å ta m shawn, marguerite å della te et sted å spise nær Rwanda .	T
Gi meg en liste av visningstider for filmer i mitt område	B
Spæll av MF Doom fra 60-talle på pandora.	N
Kor kan æ finn The World According to Paris ?	T
E det kaldt ude?	V
Putt Kan Mikami på Pre-Party R&B Jams.	V
fortell mæ koss filma som spelles på AMC teateret akkurat no	T
Sett på ein alarm for kvart over seks	V
Sett på alarm klokken 7 i morgen tidlig	V
Finn en trailer som heite Storm Cente.	N
Skru av alle alarmer.	V
minn mæ på å send inn mine timeplana hver mandag innen slutten av dagen	T
Kordan farevarsel har æ?	N
Sett to alarma for i mårra.	N
Spill en sang fra 2004	N
Kor varmt e det?	V
meg og imelda vil ha en reservasjon i Missouri klokken 19	V
Sætt alarmen før kl 6 i mårra.	N
Vis alle alarma.	N
Ver så snill å sett en alarm til klokka 4 på søndag.	V
Minn meg på å kjøpa kaffi på Starbucks denne ettermiddagen	V
Book en restaurant te ni stykker i Statham for meg	V
Slumre alle alarma.	N
Skru av alarmen	V
Minn mej på å kjøpe melk i kveld.	V
Ska det bli kaldere i Sinclair on åtta timer?	V
Spill opera musikk på google musikk	T
Spæll enn sang av Juanes på Last Fm.	N
Eg vil finne programmet From Where to Eternity	V
Ka e fuktigheten i dag?	V
book et bord i Fairwood eller i nærheta	N
ska det regn på lørdag?	T
finn lydsporet som hete The House of the Yellow Carpet	T
Hva sier værmeldingen for dette området om atten minutter om kalde temperaturer?	B
Søk på Chasing Fortune TV serien.	V
Reserver en restaurant klokka seksten i SC	T
E det kalt ude i dag?	V
ska det regn i nærheten av min nåværende posisjon klokka tolv?	T
avbryt alle alarmer	V
Ska d vær storm idag?	V
Kommer det til å snø på torsdag?	B
Kanseller alle alarma.	N
Vis påminnelsen min	V
Slett påminnelsen min om å plukke opp Patrick fra skolen i morra.	T
Finn et bilde som hete Between the Days	N
Gi denne stilen tre av seks stjerner	B
Spel litt melodi fra åttiårene på Spotify	V
Katti skal han rægne?	N
Ska det regna i dag?	V
Spill den beste Charles Neidich sangen for meg	V
Sett på en alarm for klokkå 6 på Ons	V
blir det kjørligar i La Mesa	T
ska det regn i helga?	T
Korr varmt e det?	T
Kommer det til å være stormer i Bordentown i dag?	V
Æ gjer Hadon of Ancient Opar to av 6 poeng.	N
Finn filmtidene for meg	B
spill Fereydoun Farrokhzad beste låt	V
spill albume Everybody Happy av Lee Aaron	T
E det kaldt ute?	V
spill Fereydoun Farrokhzad beste låt	T
Finn bilde Louder than bombs.	V
På dn trettende mai, 2037 koss kjæm dt te å vær i Wilderville , Montenegro	T
Kordan blir været å være om seks minutta i nærheta av Moosic	N
Kanseller alarmen for i morga tidlig.	V
Ska det bli sol i dag?	T
Kati vil Santikos Theatres visa animerte filmer	V
Vis mæ TV programmet Limit of Love: Umizaru	N
vis mæ mine påminnelsa	T
Kjæm æ te å træng en jakke i dag?	T
Legg t Nastya Kamenskih-sangen t min The Martin Garrix Show spillelista.	V
Finn et bord til én person på et populært charrascaria om tre uker fra nå av	B
Slå av alle alarman	T
legg til Kan Mikami på Pre-Party R&B Jams	V
Finn en restaurant i FM som serverer quiche	V
Sett alrmen før kl 5.	N
ska det regn idag?	T
Når ska det slutta å regna?	V
Ka er værmelding de neste 5 dagene	V
Jeg vil høre på musikken til Ghost in the Shell: Stand Alone Complex	B
Skal det blåse klokka 4 i NY.	V
E treng t bord for 4 rundt midnatt	T
Slett alle påminnelsa	T
Ka sei han om tempraturan her om 18 minutta?	N
legg t sporet 70s smash hits t min	V
legg t bob klose i la mejor música para tus fiestas	V
kanseller alle alarmer	V
Sett en alarm hvert tiende minutt.	N
E det kaldt i dag?	V
Sett alarmen for kl 5 i kveld.	N
Kjæm dt te å vær en storm i nærheten	T
Skru av alarm.	N
Skal det ver sol i dag?	V
Legg t Nastya Kamenskih-sangen til Martin Garrix show-spillelista mi	T
Avbryt alarmen for i dag ettermiddag	B
E det kaldt ute?	T
Finn filmprogrammet til ArcLight Hollywood	V
Bestill et bord i området rundt Fairview	V
legg te den Nastya Kamenshih sangen te min The Martin Garrix Show spilleliste	T
Eg vil hørra på Music of Ghost in the Shell: Stand Alone Complex	V
Sett en alarm før kl 6 på onsdag.	N
Vis alle påminnelsan mine	T
Gi meg en liste for filmtider av filmer i området	V
Book en reservasjon for 7 folk på The French Laundry åttende juni, 2029	V
Når ska det regna i dag?	V
Komme d t å vær sol idag?	V
vis alle alarmer	V
ska det bli storm i Bordentown i dag?	T
Hvilke alarmer er skrudd på?	B
Eg vil høre på litt musikk fra femtitallet	V
æ vil hør på nå musikk fra femti-tallet	T
Sett på ein alarm te klokkå fem om morningen	V
Vis alle alarman.	N
Kanseller alle alarma.	V
Finn ein restaurant i FM som servere quiche	V
E gir Mirrorshades tre stjerna	T
komme d t å vær snøstorm på min nåværandes posisjon?	V
Book et bord i nærheita av Fairview.	N
Minn meg på å sende inn timeplanen min hver mandag innen slutten av dagen	B
Ka komme været t å vær i Bahamas elleve og et halvt år fra nå	V
ka e værmeldinga for skyforholdan klokka 15:04 i Georgia i Valley View?	T
for Mirrorshades gir eg stjerner	V
Ranger dette essayet tri av 6 stjerner	V
Slett alle alarmer	B
slå av påminnelsen min om å send melding te pappa	T
Kor varmt er det?	V
Ka e luftfuktigheta idag?	T
legg Kan Mikami på Pre-Party R&B Jams	V
Hvor varmt er det?	B
Blir det sol i dag?	N
Vis alle alarmene.	V
Blir det å regne på lørdag.	N
Kanseller alarmen.	N
Gi den romanen her 3 av 6	T
Ka farevarsler har eg?	V
Sett alarm hvert min for 11 minutta	T
Er det varmt ude?	V
Hvordan skal være være i Arizona 3. oktober?	B
Burde eg ha på jakke i dag	V
ka e været i nærheten av Triumph	T
Slå på alarm til klokka 6	T
Gi The Art of Nijinsky 5 poeng	T
Book en resturant i nærheita av Montana som servere mat fra Sri-Lanka for 6 folk som har høg score.	N
æ ser etter et sted å ta med shawn, marguerite og della å spis i nærheten av Rwanda	T
Ka bli varmeindeksen i dag?	T
Spel musikk på Lastfm	V
spille Tarzan of the Apes på Cobbs Theaters?	N
Skru av alle alarmer	B
Sett en påminnelse om å stikke på butikken seinere.	V
æ treng en reservasjon for klokka seks på kvelden med en gruppe på 10 i Sand Lake	T
Ka e PW varselet for stormete ver.	V
Skru av alle alarma.	V
Kor mange tomma med regn e det ment at vi skal få i morra?	N
sett en alarm te klokka seks	T
ska d bli varmt imårå	V
Reserver et bord for 10 persona på en restaurant som tilbyr internett .	T
Ska dt regne i dag?	T
The nåværende albumet får tri av 6 poeng	V
Ranger dette essayet 2 av 6 stjerner	V
slå av alle alarma	T
ka e PW værmeldinga for stormvær	T
Legg til dinna artisten til Jazz spillelista mi.	V
gi The Art of Nijinsky fem poeng	T
Finn ut når Ghost World går på kino.	B
Sett alarm for kl. 5	V
Skru av alarmen.	V
reserver et bord for meg og min steonkel i Malta på en kafe.	V
Æ har løst å finne serien From Where to Eternity.	N
Slå av alarman	T
Spill Luis Alfonzo Larrain fra nitten fem og nitti.	N
sett en alarm for klokka seks	T
Spill albumet Vibrations av Marion Elise Raven	V
Sett på på ein alarm te kvert tredje minutt	V
Ska han komme med snystorm her?	N
Legg te ein te sang te vaskelistå	V
Alarm på	V
Gje 0 poeng av 6 til The Gate of Worlds	N
reserver en lunsj på Boreas for en gruppe på åtte	T
E det fuktig i dag?	T
reserver et bord for en gruppe på tolv på en restaurant som har internett	T
Finn meg The Twinkler som spille på National Amusements om 2 minutt	V
Bytte alarmen før i mårra tel kl. 6.	N
Ka e filmtidan for dem karibiske kinoan?	T
Legg sangen til i Para comer-spillelista mi	B
Spill en låt av Houston på Spotify.	V
Spill nokka David Mallett på last fm	N
treng æ paraply imorra?	T
finn The Ultimate Gift , et tvprogram	V
Kordan er temperaturen i London akkurat nå?	V
Finn den nærmeste kinoen som vise Operation: Kingdom	T
Kjem det t å vær storm i nærheten?	T
Vis påminnelsen min.	N
Spæll en sang fra 2004.	N
Book den bæste osteria om 7 uke.	N
Ska det regna te helgå?	V
spill de topp tjue sangene av The Kleptones på Spotify	V
spell en låt av Houston på Spotify	T
Dette albumet får tri av seks poeng	V
Søk før tv-serien Chasing Fortune.	N
Sett en alarm for klokka 5.	V
Blir det å være storm i nærheta?	N
Ka er temperaturen nå	V
Sett på en alarm for klokka kvart over 6	B
Legg te Morten Harket te tis is puccini	V
sett alarm klokka 6.15	T
Finn en reservasjon for tre på en av dei beste resturantene.	V
Sett to alarma for i morra tidli	T
Æ gjer Mirrorshades tre stjerne	N
ka ska været vær i Bahamas elve og et halvt år fra no?	T
spill musikk på Itunes	N
Kjæm vinden te å ro sæ ned hær kor æ e te middagstid?	T
Skru av alle alarmer	V
Finn et lydspor som heite The house of yellow carpet.	V
Vis meg påminnelsen	V
Skru av alarm.	B
Blir det storm i Bordentown i dag?	V
korr varmt e det i dag?	T
Finn mæ et bord førr 8 en plass i Hollenberg om ni veke.	N
Kor er påminnelsene mine?	V
Lag en reservasjon for 7 persona på The French Laundry den 8. juni, 2029	T
Ska det snø i mårå?	V
Ka kommer været til å være i Arizona på tredje oktober	V
Gje fem poeng te The Tenor Wore Tapshoes	V
Ranger den her novella 2 av 6.	N
Kanseller alarmen.	B
Les opp alle påminnelsane mine	V
book et bord i Fairview nærme området	V
Kor mange alarmer har eg på søndag?	V
Kanseller alarmen min i morra tidlig.	N
Minn meg på å gå t tannlegen neste mandag	V
påminn meg om å levere timeplanen min hver mandag på slutten av dagen	V
Eg trenge ein reservasjon for kl. 18. med ein gruppe på 10 på Sand Lake	V
Endre alarmen imorra tidlig te klokka seks.	T
Hvordan er været i nærheten av Triumph	B
Legg tel boka i 5-stjenre.	N
ka e filmtidan for Caribbean Cinemas?	T
Ka e filmtiden	N
Ska det regn nær me ved midnatt?	T
Ka e kinoprogrammet?	V
spill albumet Everybody Happy av Lee Aaron	V
Blir æ å trenge en jakke i dag?	N
E d kaldt ute?	V
spell musikk fra spillelisten Get Your Mind Right	T
Sett på ein alarm for klokkå fem	V
Vil d bli sol i dag?	N
kor varmt kommer det til å bli i dag	V
Ka e værmeldingen 15:04 i Georgia for at det e overskyet i Valley View	V
sett en alarm på mandag klokken 0300	V
vis boknavnet Straight No Chase	T
Kanseller alle påminnelsene mine.	V
burde eg ta med en paraply i dag	V
Kommer det til å bli sol i dag?	V
minn me på å kjøp kaffe på starbucks i ettermiddag	T
Sett en alarm te klokka seks	T
Finn programmet for ArcLight Hollywood	V
ka e det spådde været for min nåværende plassering neste måned?	T
putt Kan Mikami på Pre-Party R&B Jams	N
skru av alarmen	V
Vil d sny i dag?	N
Kanseller alarmen for denne ettermiddagen.	V
Imelda og jeg vil booke et rom i Missouri klokka 19.	B
æ vil sjå filmtidan for Silly Movie 2.0 på filmhuset	T
Sett en påminnelse om å gå te matbutikken seinar	T
skru av alarm	T
Skal d bli storm i dag?	N
Spill shadowplay av Dana på Deezer	V
Finn filmtida for ArcLight Hollywood	T
Sett på en alarm hvert minutt i 11 minutt	T
Vis meg alle alarmene	V
Ka e påminnelsene mine?	V
Ka e påminnelsan mine?	T
Slett påminnelsen min om å plukk opp Patrick fra skolen imorra.	T
Eg gir Hadon of Ancient Opar to av 6 poeng	V
Finn The Ultimate Gift, tv-serien.	N
reserver et bord i dag på et steakhouse for åtte som servere sashimi	V
Skal det storme i dag?	V
vis alle påminnelser	V
Æ treng en alarm te klokka fem te å minn mæ på å ta medisinen min	T
Læs opp påminnelsan mine.	T
Legg til en påminnelse om svømming klokka 11 i morgen	B
Ka er luftfuktigheten i dag	V
Kass filmar e planlagt i nabolaget ?	V
Ka er varmeindeksen i dag?	V
Kan du sette på en alarm for hvert femte minutt i tjue minutter?	B
Sett påminnelse om mammas besøk neste uke	T
E det overskya i dag?	T
Kommer det til å bli fint vær i morgen	B
fortell meg værmeldingå for de neste 3 dagene	V
Finn videospillet som heter IBM Program temporary fix	B
Spill musikk på Lastfm	V
Gi ut 2 av 6 poeng te A Tale of Time City	V
Ska det bli sol i dag?	T
Kommer det en storm i nærheten	V
Kommer det til å blåse klokka 16:00 i New York?	B
spill albumet Everybody Happy av Lee Aaron	V
sett en alarm for mandag kl 3 om morran	T
Vis alle alarmer	V
E treng en alarm klokka 17 for å minn me på å ta medisinen min	T
slå av alarmen	T
Kan e sjå filmen schedules?	T
Vis mæ ei bok som heite Straight No Chase.	N
Æ gjer albumet 3 av 6 poeng.	N
e det kaldt ut idag?	T
Finn en restaurant i FM som servere quiche	N
Spill en sang av Juanes på LastFm.	V
Burde eg ha på meg en jakka idag	V
ska dt bli varmt i morra	T
Eg vil hørra på en konsert fra Timour Mountsouraev .	V
Lag en ny alarm førr klokka ett på torsdag.	N
vis alle påminnelsa	T
Finn filmtidene for filmer i nærheten	V
kass alarmer har eg satt på?	V
spill en melodi fra åttitallet på Spotify	V
Book et bord for åtte i dag på et biffhus som servera sashimi.	V
Lægg tel Bob Klose tel la mejor música para tus fiestas.	N
Burde ej ta med paraply i dag?	V
Fjern alle påminnelsa	T
Slætt påminnelsen om å plokke opp Patrick etter skoln i mårra.	N
Sett en alarm for å da te matbutikken seinere	T
Vis påminnelsen min	B
Vis alle påminnelsene for i morga tidlig.	V
Spill opera musikk fra Google Music	N
Ka alarmer har eg på?	V
E det någen advarseler for veret i dag?	V
e d varmt ute	V
Slett alle påminnelser.	V
legg te bob klose te i la mejor m√∫sica para tus fiestas	V
Skru av alarmen.	V
Er det tåkete i dag?	V
Ska dt regne på lørdag?	T
Avbryt alarmer	V
koss e været denne ukå?	V
Sett en alarm for klokka 6.	V
Når kommer Santikos Theatres til å vise tegnefilmer?	B
Spill en melodi fra åttitallet fra Spotify	N
Kor varmt blir det i dag?	N
Når ska dt regne?	T
Lægg tel den her sangen tel in the arms of a woman .	N
Ka e værmeldingen for de neste 5 dagene?	V
minn meg på å kjøpa melk i kveld	V
Vis alle alarmer	B
Spill musikk på Itunes	B
e det varmt ut?	T
Komme d t å regna neste uka	V
Sett en alarm for klokka 5 i kveld.	V
ka alarmer har eg satt på?	V
Finn et spel som hette IBM Program temporary fix	V
legg cross bones stil te Guest List TaKe	T
Legg bright and breezy t This is Gucci Mane spillelistå mi	V
ka e værmeldinga for dem 5 neste dagan?	T
Slett påminnelsen min for å hente Patrick fra skolen i morgen.	V
Finn traileren te Storm Center	V
Spill ei låt av Houston på Spotify	B
Spill musikk fra spillelisten Get Your Mind Right	V
Komme d t å blåsa idag?	V
opprett en ny alarm for torsdag klokka 13	T
Skru av alramn.	N
Hva er temperaturen nå?	B
Vis mej TV showet Limit of Love: Umizaru.	V
Sett på en påminnelse om å gå t butikken seinare	V
Bestill bord for 10 personer på en restaurant som tilbyr internett.	B
E d under frystepunktet i dag?	N
Legg te denne sangen te perfect italian dinner spillelisten min	V
Eg vil ha ein reservasjon te klokkå seks te ti stykk	V
Ka e mine påminnelsa?	T
Sett på ein alarm te mandag klokkå tri om nattå	V
Ska det blås idag?	T
vis alle alarmer	V
Sett alrmen før 7:20 før sko utgivelsen.	N
Burde jeg ta på meg jakke i dag?	B
I vill resevera ein restaurant	V
Stacy, watson og adriana he lyst til å stikke til den beste osteriaen i Hallowell Minnesota dinna ettermiddagen.	V
Sett alarm fir kl 6:30 i mårå.	V
Kor varmt e det?	N
Kjæm dt te å vær snø på min nåværende posisjon innen 3. mars ?	T
Kor kaldt kommer det til å være i dag?	V
treng æ en jakke idag?	T
SKa d rængene i hælga?	N
Spel den beste Charles Neidich sangen	V
reserver et bord i Fairview rundt i området	V
sett en alarm for kl 6	V
Vis mæ fotoe Rock You Baby	T
Trenger eg jakke i dag?	V
Book et bord i nærheten av Fairview.	V
For Mirrorshades så gir eg d 3 stjerner	V
show av From South Africa to South Carolina	V
Finn filmprogrammene for kinoer i nærheten	V
Legg te Nastya Kamenskih sangen te i The Martin Garrix Show sillelistå mi.	V
når kan æ sjå A Handful of Dust i et filmteater?	T
Skru av alarmen.	N
Finn en reservasjon for en pub som servera pizza for 6 persona.	V
gi den nåverende bokå tri stjerner	V
spell en sang av Juanes på Last FM.	T
Når kjæm dt te å stoppe å regne?	T
ka e den nåværandes temperaturen	V
Gje fem poeng te The Art of Nijnsky	V
legg til bob klose til la mejor musica para tus fiestas	V
Sett en alarm førr klokka syv i morra tidlig	N
Slætt alle alarman.	N
Minn meg på å dra te tannlegen neste mandag.	V
Ska dt regne i dag	T
Eg og Imelda vil ha en reservasjon i Missouri klokkå syv om mornigen	V
gi dn aktuelle boka tre stjerna	T
Finn et bord for en på en populær churrascaria om tre uka fra no	T
Sku av alle alarmene	V
Ka e tempraturn i dag?	N
Skru av alarm.	N
Vil det bli kaldar i La Mesa?	N
Vis alle alarmene.	V
Finn et bord for 8 te mæ et sted i Hollenberg om ni uka	T
Spel shadowplay av Dana på Deezer	V
Kor mange mm ska det regne i morgen?	V
komme d t å snø idag	V
ka e temperaturen akkurat no	T
Vis meg Happiness was Free	B
burde æ ta m en paraply i dag	T
Har eg satt någen påminnelser?	V
book førr 3 i U.S. Virgin Islands	N
Kor varmt e det?	V
vis me påminnelsan mine	T
Finn mæ Twinkler playing på ational Amusements på 2 min.	N
Æ vil høre på nokka femtitalls musikk.	T
Reserver en restaurant klokken seksten i SC.	V
Vis meg alle alarmene mine	B
Ka ska være i Meeres-Nationalpark Insel Bastimentos være kl 12?	N
minn mæ på å lag lunsj te Dan imorra klokka halv åtte	T
Sett en alarm for 6.15.	N
Er det fuktigt i dag?	V
Slett påminnelsen for å henta Patrick på skolen i mårå	V
E det kaldt i dag?	N
Kati blir det å slutte å regne?	N
Fjærn alle, sett alarman.	N
spill av topp tjue sanga av The Kleptones på spotify	T
Vis påminnelsen min	T
Hvilken kino er nærmest og viser filmer som begynner om nitten sekunder?	B
book et bord på et steakhouse idag for åtte som servere sashimi	V
minn meg på å senda inn læreplanene mine kvar mandag på slutten av dagen	V
Koss e det i Wilderville, Montenegro den trettende mai, 2037?	T
Eg ville gitt Half a Life tri av seks	V
Slå av alarma	T
Kor kaldt bli dt på morran?	T
Hvordan kommer det til å være i Wilderville, Montenegro, trettende mai i 2037.	B
finn filmtidan for filma i nærheten	T
Kanseller alle påminnelsene mine.	V
finn en TV serie som hete Church of the Truly Warped	T
E det kaldt ute i dag?	N
Finn en reservasjon te taverna som servere pizza for et selskap på 6	T
slå av alle alarman	T
Finn ein top-rangert restaurant med ledig for reservasjon te tri stykk	V
Hvordan er femdagersvarselet?	B
Slumre alarm	T
Ka e filmtidan?	T
ka e været i London?	V
Ka e værmeldinga de neste fem dagan?	N
Book meh en lunsj på Boreas for 8 stykke.	V
Ka e værmeldinga før Guinea-Bissau?	N
spilles Tarzan of the Apes på Cobb Theatres	T
Alarm kvart femte minutt i tjue minutt takk.	V
Kan ej sjå spilletidene til filmene.	V
Æ har løst tell å booke en restaurant	N
SKa han rægne i dag?	N
sett ein alarm for kl. 6 i mårå	V
skru av alarmen	V
Gje 0 av 6 peong tel The Gate of Worlds.	N
Vis meg bilde Rock Yoy Baby	V
sett en alarm for mandag klokkå 03	V
Ka kommer varmeindeksen til å være i dag?	V
E det fuktig i dag?	V
koss e været i london?	V
spill dæm beste tjue sangan av The Kleptones på Spotify	T
Ska det blås ute i dag?	T
E vil book en restaurant	T
Blir det å snø i dag?	N
Sei meg når det komme te å bli varmere i Kina	V
Spill toplista til Joseph Utsler.	V
Skru av alle alarmer	B
Slumra alarmen	V
Alarm på.	V
Spæl en snag av Houston på spotify.	N
Finn The Twinker som spiller på National Amusements om 2 minutter	B
vis alle alarma	T
Legg til cross bones style til Guest List Take.	V
Spill en sang av Juanes på Last FM	V
gi fem poeng til The Tenor Wore Tapshoes	V
ej trenge en alarm klokka 5 for å minne mej på å ta medisinen min.	V
spill beste låtan av Joseph Utsler	T
Reserver ein restaurant for meg te klokkå ni i Statham	V
Legg til morten harket til her e puccini.	V
Sett en påminnelse for besøk av mamma neste uka	V
ska det bli kaldt i vest-Sahara om 13 tima?	T
Katti ska han slutte å rægne?	N
når vil d slutta å regna?	V
Bestill et bord på ein restaurant nærme Montana som har Sri Lankisk mat te seks stykk som e høgt rangert på tirsdag	V
Slå av ettermiddagens alarm.	T
reserver et bord i Fairview i nærheten av område	T
kati kan æ se A Handful of Dust på kino	N
Trettende mai 2037, kordan vil det ver i Wilderville Montenegro då?	V
Ka e spilletidene for the Caribbean Cinemas.	V
kor varmt ska det bli i dag	V
Fjern alle påminnelsa	T
Blir det å være sol i dag?	N
Ska det ver vind klokkå fira på ittemiddagen i New York?	V
ska det vær en storm i nærheten?	T
Åpne Spotify og spill en sang fra tjuetallet av Richard Harvey	N
Trenger jeg en paraply i morgen?	B
Legg til Jacob Hoggard til get going spillelista mi.	V
Ska det regna på lørdag?	V
Jeg vil høre på noe musikk fra femtitallet.	B
Kordan er veret i London?	V
Endra alarmen for i mårå tidligt te klokkå seks	V
Sett en alarm kvært minutt i 11 minutt.	N
Spæll dæm mæst populære 20-tallsangan tel eland Sklar.	N
fortell mæ værmeldinga for dem neste tre dagan	T
Skal vinden slakne der ej e no til middag?	V
Sett en alarm før kvært 10 minutt, som starte 5:30 og slutte 6.	N
Alarmen e satt for mandag kl 3.	N
Ska det regna på lørdag?	V
Skru av påminnelsen om å senda melding t pappa	V
slå av alarm	T
Gje mæ en påminnelse om å fære tel tannlægen på mandag.	N
Legg te sang i min Para comer	V
reserver en restaurant som serverer agnolotti i Colorado City Idaho	V
Finn et bilde av Adventure Time: The Secret of the Nameless Kingdom	T
Book en resturant klokka 4 i Sc.	V
Påminn me om bryllupet	T
sett en alarm for femten minutta	T
kanseller alarmen min i morgen tidlig.	V
Gi 0 poeng av 6 til The Gate of the Worls	B
Hva kommer varmeindeksen til å være i dag?	B
Blir det sol i dag?	V
Mæ og Imelda ønkse en reservasjon i Missouri kl 7 i kveld.	N
spel top-tjue sangene av The Kleptones på Spotify	V
Kommer det til å være sol i morgen?	V
Ka kommer været til å være i Bahamas om elleve og et halvt år fra nå	V
Ska det bli sol i dag?	T
Korr mange mm regn ska det bli i morra?	T
Gi meg ein liste av filmtider for filmer i området.	V
Legg til meir harket til den her puccini.	N
Ka vervarsling he ej?	V
Nullstill alle alarmer som er satt	V
Spill musikk på Lastfm.	V
spel topplåter av Joseph Utsler	V
Eg ville gitt Half a Life 3 av 6	V
finn et bilde av Adventure time: The secret og the Nameless Kingdom	T
Finn The Ultimate Gift, et fjernsynsprogram	V
Vis meg fotografiet Rock You Baby	V
finn nærmeste film hus som vise Operation: Kingdom	T
æ å imelda vil ha en reservasjon i Missouri kl 7 om morran	T
Spill musikk fra spillelista Get Your Mind Right	T
Lag ein påminnelse om å dra for å svømma klokkå elleve i mårå	V
Hvilke filmer er satt opp i nærheten?	B
Vill det sny her 3 mars?	N
Kor kaldt blir det i morga tidlig.	V
e det kaldt ute i dag?	V
Hvor varmt er det?	B
Sett på alarm hvert femte minutt i 20 minutter er du snill	V
Sett en påminnelse om mamma sitt besøk neste veke.	V
Komme d t å vær sol idag?	V
Minn meg på å dra til tannlegen neste mandag.	V
gi den akutelle romanen 0 utav 6	T
E d kaldt idag?	V
Gi fem poeng til The Tenor Wore Tapshoes	B
Trenge ej en paraply i morga?	V
Bestill et bord te meg og steonkelen min i Malta på ein kafeteria	V
Book en revervasjon før 1 person 17 mars.	N
Komme det te å bli sol i dag?	V
ska det vær storm i Bordentown idag?	T
Kjæm dt te å bli kjøligere i Sinclair om 8 tima	T
Skru av alle alarmer	B
legg til et album av Joseph Myer i POP GOES THE 80s spillelista mi e du grei	N
alarm på	V
Avlys alarma	T
ska det regn på lørdag?	T
været i Tioga Colorado	V
Minn meg på å kjøpe melk i kveld	V
Finn en resturant i FM som servere quiche.	V
slett alle påminnelsan mine	T
eg vil reservere en restaurant	V
Lag en reservasjon for en av dæm bæste resturangan.	N
Blir det å være vind i dag?	N
Vis mæ alarman mine	N
Vis meg påminnelsene mine	V
Ka ti skal det regne?	V
Spel Luis Alfonzo Larrain fra 1995	V
Kor varmt skal d bli i dag?	N
æ vil finn serien From Where to Eternity	T
Jeg vil gjerne se sagaen 12 Soulful Nights of Christmas	B
ka e værmeldinga for om atten min hær for kaldere temperatura	T
Spill noe av David Mallett på last fm	B
når ska det slutt å regn?	T
Vis mæ alle alarman mine	T
Ska det regn i dag?	T
Vis alle påminnelser for i morgen	B
Skru av alle påminnelser	V
Spill mæ den beste Charles Neidich sangen	N
Ej ville gitt Half a Life en 3 av 6.	V
reserver et bord for mæ å ste-onkelen min i Malta i en kantine	T
Skru av alle påminnelser	B
Bruk Groove Shark te å spela musikk fra åttitallet	V
Vis alle påminnelsan for imorra tidlig	T
Sett på en alarm for klokka 17 i kveld	B
legg bob klose te la mejor música para tus fiestas	T
Legg til denne artisten til Jazz spillelisten min	V
Ska han rægne i nærheita av mæ kl 12 i natt?	N
Sett en alarm te klokka sju imorra tidlig	T
Hvilken kino viser Flower and Snake klokka 08:56:29?	B
har e nån alarma på?	T
slett alle alarmer	V
Har æ noen påminnelsa?	N
Jeg vil finne showet From Where to Eternity	B
Kanseller dinna ettermiddagen sin alarm.	V
Legg til fem stjerne på denna boka.	N
koss filma ska vises i nabolaget?	T
Avslutt alle påminnelsan mine.	T
Minn meg på å kjøpe kaffe på Starbucks i ettermiddag	V
slå av alarma	T
Koss e temperaturen i London akkurat nå?	V
sett en påminnelse for besøket av mamma neste uke	T
Minn meg på om å kjøpe kaffe på Starbucks i ettermiddag	B
E Tarzan of the Apes på Cobb Theaters.	V
Ska det regna i dag?	V
Finn timeplana for Ghost World	T
Skru av alle alarma.	N
Sett på en påminnelse om å ringe skolen min på mandag klokken 16	V
Kanseller påminnelsen for møtet på hyttå	V
Book en resturang kl 9 ved Statham Book.	N
Ka e visningstidene på de karibiske kinoene?	V
book et topp-rangert osteri sju uka fra no	T
når kan eg se A Handful of Dust på kino	V
Kanseller alle alarma.	V
Skru av alle alarmer	V
Vis påminnelsen min	V
ka e værmeldingen om atten minutt her for kaldere temperaturer	V
sett alarm til klokka 5	T
legg til dennan sangen i min in the arms of a woman	N
Når ska dt regne i dag?	T
Kanseller alarmen min på lørdag.	N
Vis mæ TV showe Limit of Love: Umizaru	T
Sett en alarm klokka ti på halv åtte for sko slippet.	V
legg te Do You Love Me i acoustic soul spillelistå mi	V
Eg vil hørra på albumet Since I Saw you Last	V
Slå av alarmene	V
vis alle alarmer	V
Legg te denne sangen spelelistå mi In the arms of a woman	V
E d kaldt ute i dag?	N
E d varmt ute?	N
Er det kaldt i dag?	B
ka e PW værmeldingen for storm	V
Kommer det til å regne på lørdag?	B
Kanseller alarmen min i morra tidlig.	N
slett alle alarmer	V
Komme eg te å trenga ein kåpe i dag?	V
Kor varmt e d?	V
Slett alle alarmer	V
Fin den nærmaste kinoen som vise Operation: Kingdom.	N
Vis alle påminnelsan for imorra	T
vær i Tioga Colorado	T
Sett en alarm for hvert tiende min, start kl 5:30 å slutt kl 6 om morran.	T
Komme det te å bli sol i dag?	V
slå av alarm	T
Vis meg alle påminnelsene for i mårå tidligt	V
påminn me å lever undervisningsplanan mine hver mandag innen slutten på dagen	T
Gje mæ en påminnelse om å kjøpe kaffe på Starbucks i ættermiddag.	N
Gje tri av seks sterner te My Sister, My Love	V
Når ska det regn?	T
Vis alle påminnelsa for i morra	T
Ska d regna på lørdag?	V
Skal det regne i helga?	V
Sett alarm for kl 17 i kveld	T
Legg til dinna sangen til in the arms of a woman spillelista mi.	V
I vinter vil meredith, betty og erika ete på en gastropyb som e i samme område som frans.	V
korr mange inches av regn ska vi få imorra?	T
Kor kaldt blir det å være i morra tidlig?	N
book en restaurant klokka 16 i SC	T
Bestill plass på The Halal Guys 17. oktober	B
Sett på ein alarm for klokkå syv i mårå	V
ta på Kan Mikami på Pre-Party R&B Jams	V
Komme d t å regna i helgå?	V
Sett en påminnelse om at æ skal svømme i morra klokka 11.	N
Gi denne boka tre stjerner	B
Vis alle påminnelsene for i morgen	V
Vis mæ påminnelsen	N
Finn The Ultimate Gift, et tv-show	B
Er det fuktig i dag?	V
Koss e luftfuktighetsnivået idag	V
Spel den mest populære tjuetalls pladå av Leland Sklar	V
spell Shadowplay av Dana på Deezer	T
Ska det snø denne ukå?	V
korr varmt ska det bli i dag	T
Sett ein alarm for kl. 6 på ons	V
Kor varmt e det?	V
Minn mej på å ringe mamma i dag klokka 2.	V
Spill dei to tjue sangene av The Klaptons på spotify.	V
reserver for 3 på De amerikanske Jomfruøyer	V
Spill en låt av Houston på spotify	V
Skru av alarmen for i ittemiddag	V
Legg til bright and breezy til This is Gucci Mane spillelista mi	N
finn en kino med Life and Death	T
E det kaldt ute i dag?	V
sett på alarm for kvart tredje minutt	V
finn filmtidan for kinoa som e nærme	T
e vil finn showet From Where to Eternity	T
legg t Armen Movsessian t this is skepta-spillelista	T
Spel någe David Mallett på last fm	V
slå av alle alarma	T
Kafforein kino vise Flower and Snake klokkå 08:56:29?	V
Æ ville gitt Half a Life 3 utav 6	T
Sett på to alarmer for i mårå tidligt	V
finn et videospel som hette IBM Program temporary fix	V
legg te Armen Movsessian te Dette er skepta spillelisten	T
Vis meg påminnelsen	V
spell nå David Mallett på last fm	T
Spæll David Mallett på last fm.	N
På den trettende mai, 2037 kossen vil det vær i Wilderville ,Montenegro	V
Ka bli været i Bahamas om 11 og et halvt år fra no?	T
Eg trenger en alarm til klokken 1700 for å ta medisinene mine	V
Legg denne artisten til min Jazz-spilleliste	B
skru av alarm	V
E det varmt ute	T
Vil det være kaldat i Sinclair om 8 tima?	N
sett alarm for hvert tredje minutt	T
skru av alarmen	V
finn bildet Louder Than Bombs	V
Skru av alarmen min for i morra tidlig	T
minn mæ på å kjøp kaffe på starbucks i ettermiddag	T
Gje null av seks stjerner te denne romanen	V
Vis mej alle alarma.	V
Skru av alarmen.	V
Æ treng en reservasjon på en restaurant rundt midnatt.	N
Når kan jeg se A Handful of Dust på kino	B
Skru av alle påminnelser	V
vis bok vd navn Straight No Chase	T
finn lydspor m tittelen The House of the Yellow Carpet	T
Skru av alle alarmer	V
komme det te å snø i dag?	V
Æ vil høre på Music of Ghost in the Shell: Stand Alone Complex	T
slå av alarm	T
Spill noe David Mallet på last fm	V
Vis mej From South Africa to South Carolina.	V
Ranger the Art of Nijinsky 5 poeng.	V
Gje dettan essayet 2 av 6 stjerne	N
Eg hadde likt å se sagaen 12 Soulful Nights of Christmas	V
spill av musikk på itunes	T
Kas kino vise Flower and Snake klokka 08:56:29 ?	N
Kor kaldt blir det å være i dag?	N
Kommer det til å være sol i dag?	V
Eg har lyst å reservera ein restaurant	V
Lægg tel ross bones style til Guest List TaKe.	N
Finn film tidsplanen for Marcus Corporation .	T
Book et bord førr åtte på et steakhouse som servere sashimi	N
Book en resturang kl18 i SC.	N
finn et videospell som heite IBM Program midlertidig fiks	T
Vis me værmeldinga for Wisconsin	T
Finn en TV serie som hete Church of the Truly Warped .	N
Spel musikk fra spelelistå Get Your Mind right	V
Kanseller alle påminnelser	V
Spill albumet Everybody Happy av Lee Aaron.	V
Kor kaldt ska det bli om morningen?	V
E gir Hadon of Ancient Opar to av seks poeng	T
Kommer det til å regne i dag?	B
Koss komme været te å bli om seks minutter nærme Moosic	V
Hvordan blir været i Isla Bastimentos marine nasjonalpark klokka 12:00?	B
ska det vær snøstorm i min nåværende posisjon?	T
ska d regna idag?	V
alarm på	T
Ka e fuktighetsgraden i dag?	V
Ka ti det skal bli varmere i Kina.	V
Skru av alle påminnelsan for i morra	T
Lag en my alarm for torsdag kl 13.	T
reserver for 3 i U.S. Virgin Islands	T
Sett en alarm te klokka seks imorra tidlig	T
Er det kaldt ute i dag?	B
Putt Do you love me på den akustiske soul spillelista mi.	V
Finn et fotografi av Adventure Time: The Secret of the Nameless Kingdom	V
Gi den noverende novellen en tre av seks rangering.	V
Avbryt påminnelsen om møtet på hyttå	V
Spill albumet Everybody Happy av Lee Aron	B
Ranger denne romanen til 0 av 6	B
ska d snø på torsdag	V
Ønsker å høre på albumet Since I Saw You Last	V
ka e forutsett vær for min nåværende plass nest måned ?	T
ska det vær kjørlig i Vest-Sahara om tretten tima?	T
spill en låt fra 2004	T
Æ vil høre på the Music of Ghost in the Shell: Stand Alone Complex	N
Spæll musikk fra spællelista Get Your Mind Right.	N
legg denne artisten te i Jazz spillelistå mi	V
Sett på en alarm for klokka 5	B
stacy watson og adriana vil gå t d beste osteria i Hallowell Minnesota denna ettermiddagen	V
Gje mæ en påminnlese om å lage Dans lunch kl 7:30 i mårra.	N
Ka påminnelsa har æ?	T
Gi den nåværende romanen ein 3 av 6 vurdering	V
Ka tid spele Utamaro and His Five Women på Alamo Drafthouse Kino.	V
Minn mæ på å kjøpe melk i kveld.	N
Når komme Santikos Theatres te å visa animerte filmer	V
Bestill et bord for 1 person 17. mars	B
Skru av alle alarmer.	B
Eg ville gjerne ha lagt te dette albumet i funtime.	V
sett på alarm hvert tredje minutt	V
Vis meg Happiness Was Free	V
Finn The Twinkler som spilla på National Amusements om to minutt.	V
Legg t den sangen her t den perfekte italienske middag-lista	T
Kanseller alle påminnelser	V
Jeg gir Half a Life 3 av 6	B
Minn meg på å lage lunsj til dan klokka 07:30 i morgen	B
Eg ville gitt Half a Life 3 av 6	V
Sætt alarmen før kl 06.	N
Ska det regna te helgå?	V
Ka e værmeldinga for der e e no, neste måned?	T
Lag ein påminnelse for å minna meg på å ringa skolen på mandag klokkå fira	V
Sett på på ein alarm te klokkå fira på lørdag takk	V
Lag en ny alarm for torsdag klokka 13	B
Finn en restaurant i FM som servere quiche	T
Eg vil hørra på femtitallsmusikk.	V
Finn filmtidene for meg	V
Eg vil høre på musikken til Ghost in the Shell: Stand Alone Complex	V
Kommer det til å regne i helgen?	V
Sett en alarm klokka 7.	V
Husk å minn meg på å lever min emneplan kvær mandag til slutten av mnd.	N
Gje mæ en påmindelse om bryllupe.	N
Fjern påminnelsen min om å send melding te pappa	T
Ranger The Art of Nijinsky med 5 poeng	V
Vis alle alarmer	V
Slett alle påminnelser.	B
finn et videospill som hete IBM Program temporary fix	N
Slett alle påminnelser	V
Skal det ver sol i dag?	V
Ska det regna i dag?	V
Finn film tidsplanen for Arclight Hollywood .	T
Ka e filmtidene til de Karibiske Kinoene	V
korr varmt blir det idag?	T
Eg har lyst å hørra på ein concerto fra Timour Moutsouraev.	V
Slumre alle alarmer	V
Spill musikk fra spillelista Get Your Mind Right	N
vennligst legg te en ny sang te klesvask spillelista	T
Finn en reservasjon på en taverna som serverer pizza for en gruppe på 6	V
Book en resturant nær Montana som servera Sri Lankisk mat for 6 folk på tirsdag som e høgt rangert.	V
Spill den beste låta til Fereydoun Farrokhzad	B
Put det her albume i dumbstep lista mi.	N
Katti kl vises Utamaroand His Five Women på Alamo Drafthouse Cinema.	N
Finn film tidsplanan for filma i nærheten	T
ska det snø imorra?	T
Slett alarmen for i mårå tidligt	V
Eg vil se visningtidene te Silly Movie 2.0 på The movie house	V
Sett på alarm klokken 6 i morgen tidlig	V
Jeg trenger et bord til fire på en restaurant rundt	B
ska dt snø på torsdag	T
Slå av alarmen.	V
spill førtitalls melodier	V
ska det snø på torsdag	V
Spill musikk på Itunes	V
finn en trailer som hete Storm Center	T
Minn meg på bryllupet	B
Finn filmprogrammene for filmar i nærheten	V
treng e jakke i dag?	T
Hvor kaldt blir det i dag?	B
spell litt melodi fra åtti-tallet på Spotify	T
stacy watson og adriana har løst tell å dra på det beste osteria i Hallowell Minnesota i ettermiddag	N
Spæll musikk på Itunes.	N
Eg ser etter et sted å ta med shawn, marguerite og della for å spise nær Rwanda.	V
ka e værmeldinga for 15:04 i Georgia for overskya forhold i Valley View	T
Skal det bli varmt i morga?	V
Når ska det regn?	T
Gi meg en påminnelse om å stenga huset kl 10 imårå.	V
Vil det regne i hælga.	N
skru av alarm	V
Kordan e være i London?	N
Skru av alle alarmer	V
Ka e varme indeksen i dag?	V
Plis fortell meg værmeldingen for Guinea-Bissau	V
Koss vil være vær i Arizona den 3. oktober	T
Gje The Art of Nijinsky 5 poeng	N
kanseller alarmen	V
spell Luis Alfonso Larrain fra 1995	T
Vis me Happiness Was Free	T
Spill en sang av Houston på Spotify	T
E vil hør på en solokonsert fra Timour Moutsouraev	T
Sett en alarm for klokka 7 i morga.	V
Sett en alarm klokka fem i ettermiddag.	N
Kor mange alarmer har eg satt på på søndag?	V
vis fram From South Africa to South Carolina	T
Slett påminnelsen min om å plukke opp Patrick på skolen i morgen	B
Avbryt alle påminnelsane mine.	V
Kanseller alle alarma.	N
Utsett alarm	T
Spel ein melodi av Houston på Spotify	V
Sett en påminnelse om å ring skolen min på mandag ettermiddag klokka fire	T
Vær så snill å fortell mæ værmeldinga for Guinea-Bissau	T
Ska det regne i dag?	V
Ka komme været i Meeres-Nationalpark Insel Bastimentos t å vær kl 12 ?	V
kordan e været denne uken?	V
vis alle alarmer	V
E det overskya i dag?	V
Stacy Watson og Adriana vil dra te den beste osterian o Hallowell Minnesota i ettermiddag	T
Book den beste osteriaen sju veke fra no av.	V
Sku av alarmen for lørdag	V
Fjern påminnelsen om møte på hytta	T
kanseller alle alarmer	V
Ka e påminnelsan mine?	N
For Mirrorshades i gjer den 3 stjenre.	N
Ska d regna på lørdag?	V
Vis mæ Happiness Was Free .	T
E det kaldt ute?	N
Ska det vær sol idag?	T
legg te denne sangen te min in the arms of a woman	V
Gi fem poeng til The tenor wore tapshoes.	V
Skal det regne i nærheten av der ej e klokka tolv?	V
Kordan vil være være om 6 min ved Moosic?	N
Ka en tæmpraturn i London før tia.	N
Kor kan æ finne The World According to Paris?	N
Sett en alarm for kl 05	V
finn The Ultimate Gift , en TV serie	T
Komme d t å vær stormar i Bordentown idag	V
Kommer det til å regne neste uke?	B
Ka værmeldinga sei før dæm næste 3 dagan.	N
ska det snø på torsdag?	T
legg te sangen 70s smash hits te min	T
Burde jeg ta med meg en paraply i dag?	B
Ka e fuktighetsnivået i dag	V
Bruk Groove Shark t å spill musikk fra 80-tallet	T
Ver så snill å legg til en ny sang i klesvask lista mi.	V
Hvordan kommer været til å være om seks minutter i nærheten av Moosic?	B
ka e temperaturen no	T
E det fuktig idag?	T
Lag en ny alarm før tirsdag kl 1.	N
Vis meg TV showet Limit of Love: Umizaru	V
Kordan blir veret der eg e nå neste måned	V
Spill noe Davis Mallet på last fm	V
Legg låt te min Para comer	T
Finn filmprogrammet til Marcus Corporation.	V
minn mæ på å dra te tannlegen neste mandag	T
Ska det snø i dag?	V
Kanseller alle påminnelsene.	V
Putt ditta albume på dumstep dangles dirty spillelista mi.	V
E filmen Tarzan of the Apes på kinoen Cobb Theatres?	N
Kanseller alarmer	V
Ska det regn neste uke	T
Legg melodi t min Para comer	V
sett på en alarm til mandag klokka 3	T
Legg til sporet 70s smash hits i min	B
Finn et bilde av Adventure Time: The Secret of the Nameless Kingdom	V
Avbryt alle alarmer	V
Kommer det til å bli fint vær i dag?	B
Jeg gir Hadon of the Ancient Opar to av seks poeng	B
Slå av alle alarman	T
Finn en trailer som hete Storm Center.	N
Ska det regne på lørdag?	V
hvilke væradvarsla har æ?	T
Blir det sol i dag?	V
Ka vil være være i Arizona den 3?	N
Kommer det til å bli fint vær i dag?	B
Endre alarmen i morra tidli te kl 6.	T
Vis meg TV-showet Limit of Love: Umizaru	B
gi novellen en anmeldelse på tre av seks	T
finn en tv-serie som hete Church of the Truly Warped	T
Sett en alarm på et kvarter.	V
Eg vil finna serien From Where to Eternity	V
E det fuktig ute i dag?	N
Minn meg på å at boligsalget avsluttes klokka 10 i morgen	B
Skru av alarm.	N
Gi den nåværandes novellå en 3 av 6 vurdering	V
Spill musikk på Lastfm	T
finn filmtidan for Marcus Corporation	T
Ska det vær sol imorra?	T
spel ein sang fra 2004	V
Reserver te tri stykk i U.S. Virgin Islands	V
Kanseller alle påminnelsa.	N
Kommer det til å storme i dag?	V
ka e værmeldingen kl 15:04 i Georgia for overskya forhold i Valley View	V
Ranger den noverende boka tre stjerne.	V
Spel top-tjue sanger av The Kleptones på Spotify	V
Reserver ein restaurant klokkå seksten i SC	V
reserver et bord i dag på et steakhouse for åtte som serverer sashimi	V
Ka filmer ska visast i området	V
Blir det å snø på nuværanes posisjon den 3. mars?	N
Ka e film tidene for Caribbean Cinemas?	V
Kordan er temperaturen i London akkurat nå?	V
Skru av alle alarmer	V
Lægg tel en ny sang i klessvask lista mi.	N
Kor kaldt blir det i dag?	V
Les opp alle påminnelsene	V
Fortell mæ når dt kjæm te å bli varmere i Kina	T
Reserver på The Halal Guys på 17. Okt.	V
Søk etter Chasing Fortune en TV serie .	T
Legg te denne sangen te spelelistå den perfekte italienske middagen	V
Kor mange alarma har æ på søndag?	N
Vis alle alarmer	B
Sei meg kass filmar som spilles av på AMC Theaters nå	V
spell ein låt fra to tusen å fire	T
æ vil hør på en konsert av Timour Moutsouraev	T
Spill shadowplav av Dana på Deezer .	T
Spill opera musikk på google music	V
Blir det å være storma i Bordentown i dag?	N
Finn et spill som hete IBM Program temporary fix	T
Komme d t å vær sol imårå?	V
gi fem poeng te The Tenor Wore Tapshoes	T
Book bord på The halal Guys på den syttende oktober.	V
Kommer det til å regne i dag?	V
Fjern alle påminnelsan mine.	N
Ka er vermeldingå for neste uga?	V
e d minusgrader idag?	V
Finn en TV serie kallt Church of the Trult Warped .	T
Eg vil se visningstidene for Silly Movie 2.0 på filmhuset	V
Gi 0 poeng av 6 til The Gate of World	V
Kortid vil Santikos kinoene vise animerte filmer	V
Æ har løst tel å se sagaen 12 Soulful Nights of Christmas	N
Spill en sang fra 2004.	V
vis alle påminnelser	V
finn mæ et bord for åtte en plass i Hollenverg om ni uka	T
Kanseller alle alarmer	V
Spel musikk på iTunes	V
Sett en alarm for kvar over seks.	V
Sett på ein alarm for klokkå seks	V
Æ vil løre på en concerto fra Timour Moutsouraev	T
når ska dem vis Utamaro and His Five Women på Alamo Drafthouse Cinema?	T
Koss e været i London?	T
Kor varmt er det	V
kor mang tomma m regn e vi antatt å få i morra?	T
Finn filmtidene for filmer i nærheten	B
Bruk Groove Shark te å spill musikk fra åttitalle	T
ka alarma har æ satt?	T
Sett en alarm hver minutt i elve minutt	T
Finn spilletida for Marcus Corporation.	V
reserver nærme Montana restaurant som servere srilankansk mat for 6 som e høyt vurdert på tors.	V
finn et bord t me for 8 et sted i Hollenberg om ni uka	T
Blir det sol i morga?	V
Komme det te å bli vind i dag?	V
Ska det regna i dag?	V
Kor mange alarmer har eg satt på for søndag?	V
Spæll shadowplay av Dana on Deezer.	N
Spill en låt av Houston på Spotify	T
Kanseller alarmen min på lørdag	V
Alarm på.	N
Minn mæ på å ringe ho Mamma i dag klokka to.	N
kati vises Utamaro and His Five Women på Alamo Drafthouse Cinema	V
Sett en alarm for klokka 6 på onsdag.	V
Burde æ ta med mæ en paraply i dag?	N
ka e den nåværende temperaturen	V
Blir det å bli kaldar i Sinclair om 8 tima	N
Ska han komme me vind i dag?	N
Skru av alle alarmer	V
Sett en alarm for kvært 5 min i 20 min.	N
Æ hadde gitt Half a Life tre av seks.	N
Book lunsj på Boreas for en gruppe på 8	T
book et bord førr mæ og ste-onkelen min på en kafeteria i Malta	N
Legg til 70-talls slagere til ... mi.	V
Katti kan vi se A Handful of Dust på kino.	N
Finn meg The Twinkler som spele på National Amuseents om 2 minutter	V
Ej vil høre på en concerto av Timour Moutsouraev.	V
Finn spilletiden førr Ghost World.	N
Visninger av From South Africa to South Carolina	B
Ka e den nermaste kinoen som kor det går ein film om nitten sekunder?	V
Gje denne romanen tri av seks	V
Ka e neste ukes værmelding?	T
Ka værvarsler har eg?	V
Slett den forrige påminnelsen min	V
Vis alle alarmer	V
ka tid vises Utamaro and His Five Women på Alamo Drafthouse Cinema	T
sett en alarm te klokka halv sju imorra	T
Sett alramen før kl 6:30 i mårra.	N
Finn mæ filmtiden	N
Gi mæ en påminnelse for husvask kl 10 på morran i morra.	T
vis boknavnet Straight No Chase	V
E ser etter et sted å spis med Shawn, Marguerite og Della nær Rwanda	T
minn me på å kjøp melk i dag	T
Spill en sang av Houston på Spotify	N
Ka e vermeldinga for dei neste 5 dagene?	V
Ska dt regne i dag?	T
Hvordan er været denne uka?	B
Ska dt bli sol i dag?	T
Trenger jeg ei jakke i dag?	B
Sett en påminnelse om å ringe skulen på mandag klokka 4.	V
Lægg tel sang til min Para comer.	N
sett på to alarma imorratidlig	T
Spill toppsangene til Joseph Utsler	V
Legg te en påminnelse om å svøm imorra klokka elve på morran	T
Tildel 0 av 6 poeng te The Gate of Worlds	V
sett en alarm for klokka fem på morran	T
sett en alarm for hvert tiende minutt, som starte 5:30 og slutte 6	T
book for 3 i U.S. Virgin Islands	T
Kanseller alarmen min for i morga tidlig.	V
finn en reservasjon for tre på en topp-vurdert restaurant	T
Skru av alle alarmer	V
Book en restaurant som servere agnolotti i Colorado City Idaho .	N
åpen Sporify og spell en sang fra tjue-tallet av Richard Harvey	T
Sett en alarm for klokka 6.	V
Vis me bildet Rock You Baby	T
Finn The Twinkler som går på National Amusements om 2 minutt	T
Vis alle alarmer	B
minn meg på å ringa mamma idag kl 14.	V
Skal det snøve her ej e no før tredje mars?	V
Skal det bli kaldere i Sinclair i åtte år.	V
kan æ se på filmtimeplana?	T
skru av alarm	V
koss væradvarsla har e?	T
Hva sier værmeldinga om neste uke?	B
Kanseller alarmen i ettermiddag.	V
Book meg lunsj på Boreas t et selskap av 8	V
minn mæ om bryllupe	T
Kor kan eg se A Handful of Dust på kino	V
Ønske å hørra albumet Since I Saw You Last	V
ka e værmeldinga for om atten minutt her for kaldere temperatura?	T
legg denna melodien t min in the arms of a woman	V
Kommer det til å bli kjøligere i La Mesa?	B
Æ har løst å booke en resturang.	N
Skru av alle alarma	T
gi den romanen her 0 av 6	T
Sett på en alarm klokken 0500	V
Avbryt alarmen min på lørdag	V
den vinteren her, så vil meredith, betty og erika ha mat på en gastropub som e i samme område som fran	T
Sett på en alarm for hvert tredje minutt	B
ska det regna i dag	V
Slett alarmen for i mårå tidligt	V
e vil gjerne sjå sagaen 12 Soulful Nights of Christmas	T
Æ gjer den her novella 3 av 6 stjærne.	N
Spæll top-20 sanga av The Kleptones på Spotify.	N
Når ska det regna?	V
finn ein kino med Life and Death	V
sett på ein alarm for femten minutter	V
Spill de tjue mest populære sangene fra The Kleptones på Spotify	B
finn det nærmeste filmhuset som vise Operation: Kingdom	V
alarm på	T
gi fem poeng te The Tenor Wore Tapshoes	T
Sett alarm for kl 5 om morran	T
Spill musikk på Lastfm	V
Kanseller alarmen min på lørdag.	V
Skru av alarmen	V
Skal det vere kaldt i vest Sahara om tretten tima.	V
Finn en trailer som hete Storm Center	T
Kan æ se katti filman går?	N
avbryt alle paminnelsar	V
Kordan e været i London?	N
skru av alarm	V
For Mirrorshades så gir eg an tri stjerner	V
Blir det storm i dag?	N
Finn The Twinkler som spille på National Amusements om 2 minutter	T
vis mæ Happiness Was Free	T
Fortell me koss filma som spille no på AMC-teatran	T
Spill Fereydoun Farrokhzad sine beste sanga.	V
spill av nokka fra Mf Doom fra sekstitallet på Pandora	T
Ska det regna i nerheden her eg e nå klokkå toll på nattå?	V
Kjem det til å regne i dag?	V
Koss alarma har e på?	T
skru av alarm	V
slå av alarm	T
Vis mej bilde Rock You Baby.	V
slett alle alarma	T
har æ på nånn påminnelsa?	T
Finn et bord te ein på ein populær churrascaria om tri ugår	V
legg te Armen Movsessian te denne skepta spillelisten	V
Skal det ver storm i dag?	V
Legg til en ny sang i klesvaskspillelista mi , værsåsnill	T
Vis mæ alle påminnelsan før i mårra.	N
Book en reservasjon for sju folk på The french Laundry den 8 juni 2029.	V
Slett alle påminnelser	V
spill av albumet Everybody Happy av Lee Aaron	T
Minn mæ på å kjøpe kaffe på Starbucks i ettermiddag.	N
E d kaldt ute?	N
gi fem poeng te The Tenor Wore Tapshoes	V
Komme d t å regna idag?	V
Hvor mange alarmer har jeg på for lørdag?	B
Korr varmt e det?	T
Sett alarm for kl 5.	N
Hvor kan jeg finne The World According to Paris?	B
Hvor varmt kommer det til å bli i dag?	B
Kanseller alarm i morgen tidlig	V
E det overskya i dag?	V
ka e værmeldinga for 15:04 i Georgia for overskya forhold i Valley View	T
Burde æ ta me en paraply i dag?	N
spill Lius Alfonzo Larrain fra 1995	V
Legg morten harket til i this is puccini	B
Legg te påminnelse om å svøm kl 11 om morran i morra	T
Koss komme været te å bli i Bahamas elleve og et halvt år fra nå	V
Ska han sny den her uka?	N
trenge eg paraply imårå	V
Skru av alarmene	B
Skal det regne nært min nuværanes posisjon klokka 0 ?	N
Spill av operamusikk på Google Music.	B
Skru av alarmen min for i morgen tidlig	B
ska det snø på den her posisjonen innen 3. mars?	T
Ka e værmeldinga for dem neste fem dagan?	T
spill sanga fra førtitallet	N
finn The Ultimate Gift, et tv-show	T
Ska det regna i dag?	V
finn animerte filmer på Caribbean Cinemas	V
E det minusgrader i dag?	N
Kan eg se kinoprogrammet?	V
Reserver meg en lunsj på Boreas for en gruppe på 8	V
Sett to alarma for i morra tidlig	T
Kor varmt skal det ver i dag?	V
ka e mine påminnelsa?	T
vis boka Straight No Chase	T
Gi mæ en påminnelse på husstenging klokka ti imorratidlig.	T
Skru av alarmen	V
Finn visningsprogramme te kinoen i nerheden	V
Ka sei værmeldinga før næste uka?	N
Skal d regne i dag?	N
Kor kan æ finne The World According to Paris?	N
Alarm på.	N
Fjern påminnelsen min om å plukke opp Patrick fra skolen i morra.	N
Når kan eg se A Handful of Dust på Kino?	V
Vis alle alarma	T
Reserver en lunsj te mæ på Boreas for et selskap på 8	T
minn meg på å laga Dan sin lunsj kl 07:30 imårå .	V
Eg har lyst å hørra på the Music of Ghost in the Shell: Stand Alone Complex	V
Ka e værmelding for 5 daga?	T
søk etter TV-serien Chasing a Fortune	T
Burde eg ha på en jakke i dag	V
Hvilke påminnelser har jeg?	B
Vurder detta essayet 2 av 6 stjerner	V
Været i Tioga Colorado	B
Sett på ein alarm te klokkå halv syv i mårå tidligt	V
ska det være varmt i morgen?	V
Ska det regna i dag?	V
Sei meg ka filmer som spilles for øyeblikket på AMC Theaters	V
Finn et bilde som heite Between the Days.	V
Sett en alarm for 6 om morran på onsdag	T
slå av alarm	T
ka e værmeldingå for om atten minutter her for kaldere temperaturer	V
Book for tre i U.s. Virgin Islands.	V
Vær så snill og legg til et album av Joseph Meyer på POP GOES THE 80s spillelisten min	V
Spel albumet Vibrations av Marion Elise Raven	V
Kanseller alarma	N
Vis meg tidene te Ghost World	V
Slå av alle alarma	T
Kanseller alarmen min på søndag.	V
Spill operamusikk på google music	T
Lag en ny alarm for torsdag kl 13.	V
spille Tarzan of the Apes på Cobb teatera?	T
Legg til Nastya Kamenskih sangen til The Martin Garrix Show spillelisten min	V
Æ vil lægge det hær albumet tel funtime.	N
Vis alle påminnelsene mine.	V
Ka vil varmeindeksen vær idag?	T
Kommer det å blåse 16 i NY	V
Ka e værmeldingen for neste uka?	V
sett alarm for kl 6 om morran	T
Legg til Nastya Kamenskih sang til The Martin Garrix Show spillelista mi.	V
Spill shadowplay av Dana på Deezer.	V
Blir det å regne i dag?	N
Finn filmtidene for Marcus Corporation.	V
Denne vinteren vil Meredith og Erika spisa på ein gastropub i samme området so Frans lokasjon	V
e tannlegetimen min i påminnelsan?	T
Ska dt bli sol i dag?	T
reserver på The Halal Guys dn 17. oktober	T
Spill nokka Mf Doom fra sekstitalle på pandora .	T
E dt skyat i dag?	T
Kor varmt e det	V
E det varmt ute?	V
Book nokka til klokka 6, nærme Montana restaurant som servere mat fra Sri Lanka og som har gode omtala på tues.	T
Spill musikk på Itunes	V
Er det fuktig i dag?	B
alarm på	T
Kanseller min siste påminnelse	V
Eg trenge en resersvasjon te kl 18. me 10 stk på Sand Lake	V
Kati blir det å regne i dag?	N
Slett alle påminnelser for i mårå	V
korr varmt blir det idag	T
Æ vil høre på en konsert av Timour Moutsouraev.	N
Kan du legge til et album av Joseph Meyer i POP GOES THE 80s-spillelista mi?	B
Slett alle satte alarmer.	V
Sett en alarm førr klokka 6 om morraen.	N
finn The Ultimate Gift	N
Bruk Groove Shark te å spela musikk fra åtti-talet	V
Sett en alarm klokka kvart over seks.	N
Spel opera musikk på google music	V
Vis alle alarmer.	B
Spæll Freudoun Farrokhzad bæste sanga.	N
